北京大学	北京市
中国人民大学	北京市
清华大学	北京市
北京交通大学	北京市
北京工业大学	北京市
北京航空航天大学	北京市
北京理工大学	北京市
北京科技大学	北京市
北京化工大学	北京市
北京邮电大学	北京市
中国农业大学	北京市
北京林业大学	北京市
北京中医药大学	北京市
北京师范大学	北京市
北京外国语大学	北京市
中国传媒大学	北京市
中央财经大学	北京市
对外经济贸易大学	北京市
北京体育大学	北京市
中央音乐学院	北京市
中央民族大学	北京市
中国政法大学	北京市
南开大学	天津市
天津大学	天津市
华北电力大学(保定)	河北省
河北工业大学	河北省
太原理工大学	山西省
内蒙古大学	内蒙古自治区
辽宁大学	辽宁省
大连理工大学	辽宁省
东北大学	辽宁省
大连海事大学	辽宁省
吉林大学	吉林省
延边大学	吉林省
东北师范大学	吉林省
哈尔滨工业大学	黑龙江省
哈尔滨工程大学	黑龙江省
东北农业大学	黑龙江省
东北林业大学	黑龙江省
复旦大学	上海市
同济大学	上海市
上海交通大学	上海市
华东理工大学	上海市
东华大学	上海市
华东师范大学	上海市
上海外国语大学	上海市
上海财经大学	上海市
南京大学	江苏省
苏州大学	江苏省
东南大学	江苏省
南京航空航天大学	江苏省
南京理工大学	江苏省
中国矿业大学	江苏省
河海大学	江苏省
江南大学	江苏省
南京农业大学	江苏省
中国药科大学	江苏省
南京师范大学	江苏省
浙江大学	浙江省
安徽大学	安徽省
中国科学技术大学	安徽省
合肥工业大学	安徽省
厦门大学	福建省
福州大学	福建省
山东大学	山东省
中国海洋大学	山东省
中国石油大学(华东)	山东省
郑州大学	河南省
武汉大学	湖北省
华中科技大学	湖北省
中国地质大学(武汉)	湖北省
武汉理工大学	湖北省
华中农业大学	湖北省
华中师范大学	湖北省
中南财经政法大学	湖北省
湖南大学	湖南省
中南大学	湖南省
湖南师范大学	湖南省
中山大学	广东省
暨南大学	广东省
华南理工大学	广东省
华南师范大学	广东省
海南大学	海南省
广西大学	广西壮族自治区
四川大学	四川省
重庆大学	重庆市
西南交通大学	四川省
电子科技大学	四川省
四川农业大学	四川省
西南大学	重庆市
西南财经大学	四川省
贵州大学	贵州省
云南大学	云南省
西藏大学	西藏自治区
西北大学	陕西省
西安交通大学	陕西省
西北工业大学	陕西省
西安电子科技大学	陕西省
西北农林科技大学	陕西省
陕西师范大学	陕西省
兰州大学	甘肃省
青海大学	青海省
宁夏大学	宁夏回族自治区
新疆大学	新疆维吾尔自治区
石河子大学	新疆维吾尔自治区
华北电力大学	北京市
中国矿业大学(北京)	北京市
中国石油大学(北京)	北京市
中国地质大学(北京)	北京市
南昌大学	江西省
上海大学	上海市
天津医科大学	天津市
长安大学	陕西省
国防科学技术大学	湖南省
第二军医大学	上海市
第四军医大学	陕西省
