北京大学	北京市
清华大学	北京市
中国人民大学	北京市
北京理工大学	北京市
北京航空航天大学	北京市
北京师范大学	北京市
中国农业大学	北京市
中央民族大学	北京市
南开大学	天津市
天津大学	天津市
东北大学	沈阳市
大连理工大学	大连市
吉林大学	长春市
哈尔滨工业大学	哈尔滨市
同济大学	上海市
上海交通大学	上海市
华东师范大学	上海市
复旦大学	上海市
南京大学	南京市
东南大学	南京市
浙江大学	杭州市
中国科学技术大学	合肥市
厦门大学	厦门市
山东大学	济南市
中国海洋大学	青岛市
武汉大学	武汉市
华中科技大学	武汉市
湖南大学	长沙市
中南大学	长沙市
国防科学技术大学	长沙市
中山大学	广州市
华南理工大学	广州市
四川大学	成都市
电子科技大学	成都市
重庆大学	重庆市
西安交通大学	西安市
西北工业大学	西安市
西北农林科技大学	咸阳市
兰州大学	兰州市
