北京大学	教育部	北京市	本科		
中国人民大学	教育部	北京市	本科		
清华大学	教育部	北京市	本科		
北京交通大学	教育部	北京市	本科		
北京工业大学	北京市	北京市	本科		
北京航空航天大学	工业和信息化部	北京市	本科		
北京理工大学	工业和信息化部	北京市	本科		
北京科技大学	教育部	北京市	本科		
北方工业大学	北京市	北京市	本科		
北京化工大学	教育部	北京市	本科		
北京工商大学	北京市	北京市	本科		
北京服装学院	北京市	北京市	本科		
北京邮电大学	教育部	北京市	本科		
北京印刷学院	北京市	北京市	本科		
北京建筑大学	北京市	北京市	本科		
北京石油化工学院	北京市	北京市	本科		
北京电子科技学院	中央办公厅	北京市	本科		
中国农业大学	教育部	北京市	本科		
北京农学院	北京市	北京市	本科		
北京林业大学	教育部	北京市	本科		
北京协和医学院	国家卫生和计划生育委员会	北京市	本科		
首都医科大学	北京市	北京市	本科		
北京中医药大学	教育部	北京市	本科		
北京师范大学	教育部	北京市	本科		
首都师范大学	北京市	北京市	本科		
首都体育学院	北京市	北京市	本科		
北京外国语大学	教育部	北京市	本科		
北京第二外国语学院	北京市	北京市	本科		
北京语言大学	教育部	北京市	本科		
中国传媒大学	教育部	北京市	本科		
中央财经大学	教育部	北京市	本科		
对外经济贸易大学	教育部	北京市	本科		
北京物资学院	北京市	北京市	本科		
首都经济贸易大学	北京市	北京市	本科		
外交学院	外交部	北京市	本科		
中国人民公安大学	公安部	北京市	本科		
国际关系学院	教育部	北京市	本科		
北京体育大学	国家体育总局	北京市	本科		
中央音乐学院	教育部	北京市	本科		
中国音乐学院	北京市	北京市	本科		
中央美术学院	教育部	北京市	本科		
中央戏剧学院	教育部	北京市	本科		
中国戏曲学院	北京市	北京市	本科		
北京电影学院	北京市	北京市	本科		
北京舞蹈学院	北京市	北京市	本科		
中央民族大学	国家民委	北京市	本科		
中国政法大学	教育部	北京市	本科		
华北电力大学	教育部	北京市	本科		
中华女子学院	中华妇女联合会	北京市	本科		
北京信息科技大学	北京市	北京市	本科		
中国矿业大学（北京）	教育部	北京市	本科		
中国石油大学（北京）	教育部	北京市	本科		
中国地质大学（北京）	教育部	北京市	本科		
北京联合大学	北京市	北京市	本科		
北京城市学院	北京市教委	北京市	本科	民办	
中国青年政治学院	共青团中央	北京市	本科		
首钢工学院	北京市	北京市	本科		
中国劳动关系学院	中华全国总工会	北京市	本科		
北京吉利学院	北京市教委	北京市	本科	民办	
首都师范大学科德学院	北京市教委	北京市	本科	民办	
北京工商大学嘉华学院	北京市教委	北京市	本科	民办	
北京邮电大学世纪学院	北京市教委	北京市	本科	民办	
北京工业大学耿丹学院	北京市教委	北京市	本科	民办	
北京警察学院	北京市	北京市	本科		
北京第二外国语学院中瑞酒店管理学院	北京市教委	北京市	本科	民办	
中国科学院大学	中国科学院	北京市	本科		
北京工业职业技术学院	北京市	北京市	专科		
北京信息职业技术学院	北京市	北京市	专科		
北京电子科技职业学院	北京市	北京市	专科		
北京京北职业技术学院	北京市	北京市	专科		
北京交通职业技术学院	北京市	北京市	专科		
北京青年政治学院	北京市	北京市	专科		
北京农业职业学院	北京市	北京市	专科		
北京政法职业学院	北京市	北京市	专科		
北京财贸职业学院	北京市	北京市	专科		
北京北大方正软件职业技术学院	北京市教委	北京市	专科	民办	
北京经贸职业学院	北京市教委	北京市	专科	民办	
北京经济技术职业学院	北京市教委	北京市	专科	民办	
北京戏曲艺术职业学院	北京市	北京市	专科		
北京汇佳职业学院	北京市教委	北京市	专科	民办	
北京现代职业技术学院	北京市	北京市	专科		
北京科技经营管理学院	北京市教委	北京市	专科	民办	
北京科技职业学院	北京市教委	北京市	专科	民办	
北京培黎职业学院	北京市教委	北京市	专科	民办	
北京经济管理职业学院	北京市	北京市	专科		
北京劳动保障职业学院	北京市	北京市	专科		
北京社会管理职业学院	北京市	北京市	专科		
北京艺术传媒职业学院	北京市教委	北京市	专科	民办	
北京体育职业学院	北京市	北京市	专科		
北京交通运输职业学院	北京市	北京市	专科		
北京卫生职业学院	北京市	北京市	专科		
南开大学	教育部	天津市	本科		
天津大学	教育部	天津市	本科		
天津科技大学	天津市	天津市	本科		
天津工业大学	天津市	天津市	本科		
中国民航大学	交通运输部	天津市	本科		
天津理工大学	天津市	天津市	本科		
天津农学院	天津市	天津市	本科		
天津医科大学	天津市	天津市	本科		
天津中医药大学	天津市	天津市	本科		
天津师范大学	天津市	天津市	本科		
天津职业技术师范大学	天津市	天津市	本科		
天津外国语大学	天津市	天津市	本科		
天津商业大学	天津市	天津市	本科		
天津财经大学	天津市	天津市	本科		
天津体育学院	天津市	天津市	本科		
天津音乐学院	天津市	天津市	本科		
天津美术学院	天津市	天津市	本科		
天津城建大学	天津市	天津市	本科		
天津天狮学院	天津市教委	天津市	本科	民办	
天津外国语大学滨海外事学院	天津市教委	天津市	本科	民办	
天津体育学院运动与文化艺术学院	天津市教委	天津市	本科	民办	
天津商业大学宝德学院	天津市教委	天津市	本科	民办	
天津医科大学临床医学院	天津市教委	天津市	本科	民办	
南开大学滨海学院	天津市教委	天津市	本科	民办	
天津师范大学津沽学院	天津市教委	天津市	本科	民办	
天津理工大学中环信息学院	天津市教委	天津市	本科	民办	
北京科技大学天津学院	天津市教委	天津市	本科	民办	
天津大学仁爱学院	天津市教委	天津市	本科	民办	
天津财经大学珠江学院	天津市教委	天津市	本科	民办	
天津市职业大学	天津市	天津市	专科		
天津中德职业技术学院	天津市	天津市	专科		
天津滨海职业学院	天津市	天津市	专科		
天津工程职业技术学院	天津市	天津市	专科		
天津青年职业学院	天津市	天津市	专科		
天津渤海职业技术学院	天津市	天津市	专科		
天津电子信息职业技术学院	天津市	天津市	专科		
天津机电职业技术学院	天津市	天津市	专科		
天津现代职业技术学院	天津市	天津市	专科		
天津公安警官职业学院	天津市	天津市	专科		
天津轻工职业技术学院	天津市	天津市	专科		
天津商务职业学院	天津市	天津市	专科		
天津国土资源和房屋职业学院	天津市	天津市	专科		
天津医学高等专科学校	天津市	天津市	专科		
天津开发区职业技术学院	天津市	天津市	专科		
天津艺术职业学院	天津市	天津市	专科		
天津交通职业学院	天津市	天津市	专科		
天津冶金职业技术学院	天津市	天津市	专科		
天津石油职业技术学院	天津市	天津市	专科		
天津城市职业学院	天津市	天津市	专科		
天津铁道职业技术学院	天津市	天津市	专科		
天津工艺美术职业学院	天津市	天津市	专科		
天津城市建设管理职业技术学院	天津市	天津市	专科		
天津生物工程职业技术学院	天津市	天津市	专科		
天津海运职业学院	天津市	天津市	专科		
天津广播影视职业学院	天津市	天津市	专科		
河北大学	河北省	保定市	本科		
河北工程大学	河北省	邯郸市	本科		
石家庄经济学院	河北省	石家庄市	本科		
河北工业大学	河北省	天津市	本科		
华北理工大学	河北省	唐山市	本科		
河北科技大学	河北省	石家庄市	本科		
河北建筑工程学院	河北省	张家口市	本科		
河北农业大学	河北省	保定市	本科		
河北医科大学	河北省	石家庄市	本科		
河北北方学院	河北省	张家口市	本科		
承德医学院	河北省	承德市	本科		
河北师范大学	河北省	石家庄市	本科		
保定学院	河北省	保定市	本科		
河北民族师范学院	河北省	承德市	本科		
唐山师范学院	河北省	唐山市	本科		
廊坊师范学院	河北省	廊坊市	本科		
衡水学院	河北省	衡水市	本科		
石家庄学院	河北省	石家庄市	本科		
邯郸学院	河北省	邯郸市	本科		
邢台学院	河北省	邢台市	本科		
沧州师范学院	河北省	沧州市	本科		
石家庄铁道大学	河北省	石家庄市	本科		
燕山大学	河北省	秦皇岛市	本科		
河北科技师范学院	河北省	秦皇岛市	本科		
唐山学院	河北省	唐山市	本科		
华北科技学院	国家安全生产监督管理总局	廊坊市	本科		
中国人民武装警察部队学院	公安部	廊坊市	本科		
河北体育学院	河北省	石家庄市	本科		
河北金融学院	河北省	保定市	本科		
北华航天工业学院	河北省	廊坊市	本科		
防灾科技学院	中国地震局	廊坊市	本科		
河北经贸大学	河北省	石家庄市	本科		
中央司法警官学院	司法部	保定市	本科		
河北传媒学院	河北省教育厅	石家庄市	本科	民办	
河北工程技术学院	河北省教育厅	石家庄市	本科	民办	
河北美术学院	河北省教育厅	石家庄市	本科	民办	
河北科技学院	河北省教育厅	保定市	本科	民办	
河北外国语学院	河北省教育厅	石家庄市	本科	民办	
河北大学工商学院	河北省教育厅	保定市	本科	民办	
华北理工大学轻工学院	河北省教育厅	唐山市	本科	民办	
河北科技大学理工学院	河北省教育厅	石家庄市	本科	民办	
河北师范大学汇华学院	河北省教育厅	石家庄市	本科	民办	
河北经贸大学经济管理学院	河北省教育厅	石家庄市	本科	民办	
河北医科大学临床学院	河北省教育厅	石家庄市	本科	民办	
华北电力大学科技学院	河北省教育厅	保定市	本科	民办	
河北工程大学科信学院	河北省教育厅	邯郸市	本科	民办	
河北工业大学城市学院	河北省教育厅	廊坊市	本科	民办	
燕山大学里仁学院	河北省教育厅	秦皇岛市	本科	民办	
石家庄铁道大学四方学院	河北省教育厅	石家庄市	本科	民办	
石家庄经济学院华信学院	河北省教育厅	石家庄市	本科	民办	
河北农业大学现代科技学院	河北省教育厅	保定市	本科	民办	
华北理工大学冀唐学院	河北省教育厅	唐山市	本科	民办	
中国地质大学长城学院	河北省教育厅	保定市	本科	民办	
燕京理工学院	河北省教育厅	廊坊市	本科	民办	
北京中医药大学东方学院	河北省教育厅	廊坊市	本科	民办	
北京交通大学海滨学院	河北省教育厅	沧州市	本科	民办	
河北中医学院	河北省	石家庄市	本科		
张家口学院	河北省	张家口市	本科		
河北工程技术高等专科学校	河北省	沧州市	专科		
河北工业职业技术学院	河北省	石家庄市	专科		
邯郸职业技术学院	河北省	邯郸市	专科		
石家庄职业技术学院	河北省	石家庄市	专科		
张家口职业技术学院	河北省	张家口市	专科		
承德石油高等专科学校	河北省	承德市	专科		
邢台职业技术学院	河北省	邢台市	专科		
河北软件职业技术学院	河北省	保定市	专科		
河北石油职业技术学院	河北省	廊坊市	专科		
河北建材职业技术学院	河北省	秦皇岛市	专科		
河北政法职业学院	河北省	石家庄市	专科		
沧州职业技术学院	河北省	沧州市	专科		
河北能源职业技术学院	河北省	唐山市	专科		
石家庄铁路职业技术学院	河北省	石家庄市	专科		
保定职业技术学院	河北省	保定市	专科		
秦皇岛职业技术学院	河北省	秦皇岛市	专科		
石家庄工程职业学院	河北省教育厅	石家庄市	专科	民办	
石家庄城市经济职业学院	河北省教育厅	石家庄市	专科	民办	
唐山职业技术学院	河北省	唐山市	专科		
衡水职业技术学院	河北省	衡水市	专科		
唐山工业职业技术学院	河北省	唐山市	专科		
邢台医学高等专科学校	河北省	邢台市	专科		
河北省艺术职业学院	河北省	石家庄市	专科		
河北旅游职业学院	河北省	承德市	专科		
石家庄财经职业学院	河北省教育厅	石家庄市	专科	民办	
河北交通职业技术学院	河北省	石家庄市	专科		
河北化工医药职业技术学院	河北省	石家庄市	专科		
石家庄信息工程职业学院	河北省	石家庄市	专科		
河北外国语职业学院	河北省	秦皇岛市	专科		
保定电力职业技术学院	河北省	保定市	专科		
河北机电职业技术学院	河北省	邢台市	专科		
渤海石油职业学院	河北省	沧州市	专科		
廊坊职业技术学院	河北省	廊坊市	专科		
唐山科技职业技术学院	河北省	唐山市	专科		
石家庄邮电职业技术学院	河北省	石家庄市	专科		
河北公安警察职业学院	河北省	石家庄市	专科		
石家庄工商职业学院	河北省教育厅	石家庄市	专科	民办	
石家庄理工职业学院	河北省教育厅	石家庄市	专科	民办	
石家庄科技信息职业学院	河北省教育厅	石家庄市	专科	民办	
河北司法警官职业学院	河北省	邯郸市	专科		
沧州医学高等专科学校	河北省	沧州市	专科		
河北女子职业技术学院	河北省	石家庄市	专科		
石家庄医学高等专科学校	河北省教育厅	石家庄市	专科	民办	
石家庄经济职业学院	河北省教育厅	石家庄市	专科	民办	
冀中职业学院	河北省	保定市	专科		
石家庄人民医学高等专科学校	河北省教育厅	石家庄市	专科	民办	
石家庄科技工程职业学院	河北省	石家庄市	专科		
河北劳动关系职业学院	河北省	石家庄市	专科		
石家庄科技职业学院	河北省教育厅	石家庄市	专科	民办	
廊坊东方职业技术学院	河北省教育厅	廊坊市	专科	民办	
泊头职业学院	河北省	沧州市	专科		
宣化科技职业学院	河北省	张家口市	专科		
廊坊燕京职业技术学院	河北省	廊坊市	专科		
承德护理职业学院	河北省	承德市	专科		
石家庄幼儿师范高等专科学校	河北省	石家庄市	专科		
廊坊卫生职业学院	河北省	廊坊市	专科		
河北轨道运输职业技术学院	河北省	石家庄市	专科		
保定幼儿师范高等专科学校	河北省	保定市	专科		
河北工艺美术职业学院	河北省	保定市	专科		
渤海理工职业学院	河北省教育厅	沧州市	专科	民办	
山西大学	山西省	太原市	本科		
太原科技大学	山西省	太原市	本科		
中北大学	山西省	太原市	本科		
太原理工大学	山西省	太原市	本科		
山西农业大学	山西省	晋中市	本科		
山西医科大学	山西省	太原市	本科		
长治医学院	山西省	长治市	本科		
山西师范大学	山西省	临汾市	本科		
太原师范学院	山西省	太原市	本科		
山西大同大学	山西省	大同市	本科		
晋中学院	山西省	晋中市	本科		
长治学院	山西省	长治市	本科		
运城学院	山西省	运城市	本科		
忻州师范学院	山西省	忻州市	本科		
山西财经大学	山西省	太原市	本科		
山西中医学院	山西省	太原市	本科		
吕梁学院	山西省	吕梁市	本科		
太原学院	山西省	太原市	本科		
山西应用科技学院	山西省教育厅	太原市	本科	民办	
山西大学商务学院	山西省教育厅	太原市	本科	民办	
太原理工大学现代科技学院	山西省教育厅	太原市	本科	民办	
山西农业大学信息学院	山西省教育厅	晋中市	本科	民办	
山西师范大学现代文理学院	山西省教育厅	临汾市	本科	民办	
中北大学信息商务学院	山西省教育厅	太原市	本科	民办	
太原科技大学华科学院	山西省教育厅	太原市	本科	民办	
山西医科大学晋祠学院	山西省教育厅	太原市	本科	民办	
山西财经大学华商学院	山西省教育厅	太原市	本科	民办	
山西工商学院	山西省教育厅	太原市	本科	民办	
太原工业学院	山西省	太原市	本科		
山西传媒学院	山西省	太原市	本科		
山西工程技术学院	山西省	阳泉市	本科		
山西省财政税务专科学校	山西省	太原市	专科		
山西警官高等专科学校	山西省	太原市	专科		
长治职业技术学院	山西省	长治市	专科		
山西艺术职业学院	山西省	太原市	专科		
晋城职业技术学院	山西省	晋城市	专科		
山西建筑职业技术学院	山西省	太原市	专科		
山西药科职业学院	山西省	太原市	专科		
山西工程职业技术学院	山西省	太原市	专科		
山西交通职业技术学院	山西省	太原市	专科		
大同煤炭职业技术学院	山西省	大同市	专科		
山西机电职业技术学院	山西省	长治市	专科		
山西戏剧职业学院	山西省	太原市	专科		
山西财贸职业技术学院	山西省	太原市	专科		
山西林业职业技术学院	山西省	太原市	专科		
山西水利职业技术学院	山西省	运城市	专科		
阳泉职业技术学院	山西省	阳泉市	专科		
临汾职业技术学院	山西省	临汾市	专科		
山西职业技术学院	山西省	太原市	专科		
山西煤炭职业技术学院	山西省	太原市	专科		
山西金融职业学院	山西省	太原市	专科		
太原城市职业技术学院	山西省	太原市	专科		
山西信息职业技术学院	山西省教育厅	临汾市	专科	民办	
山西体育职业学院	山西省	太原市	专科		
山西警官职业学院	山西省	太原市	专科		
山西国际商务职业学院	山西省	太原市	专科		
潞安职业技术学院	山西省	长治市	专科		
太原旅游职业学院	山西省	太原市	专科		
山西旅游职业学院	山西省	太原市	专科		
山西管理职业学院	山西省	临汾市	专科		
山西电力职业技术学院	山西省	太原市	专科		
忻州职业技术学院	山西省	忻州市	专科		
山西同文职业技术学院	山西省教育厅	晋中市	专科	民办	
晋中职业技术学院	山西省	晋中市	专科		
山西华澳商贸职业学院	山西省教育厅	晋中市	专科	民办	
山西运城农业职业技术学院	山西省	运城市	专科		
运城幼儿师范高等专科学校	山西省	运城市	专科		
山西老区职业技术学院	山西省教育厅	太原市	专科	民办	
山西经贸职业学院	山西省	太原市	专科		
朔州职业技术学院	山西省	朔州市	专科		
运城职业技术学院	山西省教育厅	运城市	专科	民办	
山西轻工职业技术学院	山西省	太原市	专科		
晋中师范高等专科学校	山西省	晋中市	专科		
阳泉师范高等专科学校	山西省	阳泉市	专科		
山西青年职业学院	山西省	太原市	专科		
运城护理职业学院	山西省	运城市	专科		
运城师范高等专科学校	山西省	运城市	专科		
朔州师范高等专科学校	山西省	朔州市	专科		
吕梁职业技术学院	山西省	吕梁市	专科		
内蒙古大学	内蒙古自治区	呼和浩特市	本科		
内蒙古科技大学	内蒙古自治区	包头市	本科		
内蒙古工业大学	内蒙古自治区	呼和浩特市	本科		
内蒙古农业大学	内蒙古自治区	呼和浩特市	本科		
内蒙古医科大学	内蒙古自治区	呼和浩特市	本科		
内蒙古师范大学	内蒙古自治区	呼和浩特市	本科		
内蒙古民族大学	内蒙古自治区	通辽市	本科		
赤峰学院	内蒙古自治区	赤峰市	本科		
内蒙古财经大学	内蒙古自治区	呼和浩特市	本科		
呼伦贝尔学院	内蒙古自治区	呼伦贝尔市	本科		
集宁师范学院	内蒙古自治区	乌兰察布市	本科		
河套学院	内蒙古自治区	巴彦淖尔市	本科		
呼和浩特民族学院	内蒙古自治区	呼和浩特市	本科		
内蒙古大学创业学院	内蒙古自治区教育厅	呼和浩特市	本科	民办	
内蒙古师范大学鸿德学院	内蒙古自治区教育厅	呼和浩特市	本科	民办	
内蒙古艺术学院	内蒙古自治区	呼和浩特市	本科		
鄂尔多斯应用技术学院	内蒙古自治区	鄂尔多斯市	本科		
内蒙古建筑职业技术学院	内蒙古自治区	呼和浩特市	专科		
内蒙古丰州职业学院	内蒙古自治区教育厅	呼和浩特市	专科	民办	
包头职业技术学院	内蒙古自治区	包头市	专科		
兴安职业技术学院	内蒙古自治区	兴安盟	专科		
呼和浩特职业学院	内蒙古自治区	呼和浩特市	专科		
包头轻工职业技术学院	内蒙古自治区	包头市	专科		
内蒙古电子信息职业技术学院	内蒙古自治区	呼和浩特市	专科		
内蒙古机电职业技术学院	内蒙古自治区	呼和浩特市	专科		
内蒙古化工职业学院	内蒙古自治区	呼和浩特市	专科		
内蒙古商贸职业学院	内蒙古自治区	呼和浩特市	专科		
锡林郭勒职业学院	内蒙古自治区	锡林郭勒盟	专科		
内蒙古警察职业学院	内蒙古自治区	呼和浩特市	专科		
内蒙古体育职业学院	内蒙古自治区	呼和浩特市	专科		
乌兰察布职业学院	内蒙古自治区	乌兰察布市	专科		
通辽职业学院	内蒙古自治区	通辽市	专科		
科尔沁艺术职业学院	内蒙古自治区	通辽市	专科		
内蒙古交通职业技术学院	内蒙古自治区	赤峰市	专科		
包头钢铁职业技术学院	内蒙古自治区	包头市	专科		
乌海职业技术学院	内蒙古自治区	乌海市	专科		
内蒙古科技职业学院	内蒙古自治区教育厅	呼和浩特市	专科	民办	
内蒙古北方职业技术学院	内蒙古自治区教育厅	呼和浩特市	专科	民办	
赤峰职业技术学院	内蒙古自治区教育厅	赤峰市	专科	民办	
内蒙古经贸外语职业学院	内蒙古自治区教育厅	呼和浩特市	专科	民办	
包头铁道职业技术学院	内蒙古自治区	包头市	专科		
乌兰察布医学高等专科学校	内蒙古自治区	乌兰察布市	专科		
鄂尔多斯职业学院	内蒙古自治区	鄂尔多斯市	专科		
内蒙古工业职业学院	内蒙古自治区教育厅	呼和浩特市	专科	民办	
呼伦贝尔职业技术学院	内蒙古自治区	呼伦贝尔市	专科		
满洲里俄语职业学院	内蒙古自治区	呼伦贝尔市	专科		
内蒙古能源职业学院	内蒙古自治区教育厅	呼和浩特市	专科	民办	
赤峰工业职业技术学院	内蒙古自治区	赤峰市	专科		
阿拉善职业技术学院	内蒙古自治区	阿拉善盟	专科		
内蒙古美术职业学院	内蒙古自治区教育厅	巴彦淖尔市	专科	民办	
内蒙古民族幼儿师范高等专科学校	内蒙古自治区	鄂尔多斯市	专科		
鄂尔多斯生态环境职业学院	内蒙古自治区	鄂尔多斯市	专科		
扎兰屯职业学院	内蒙古自治区	呼伦贝尔市	专科		
辽宁大学	辽宁省	沈阳市	本科		
大连理工大学	教育部	大连市	本科		
沈阳工业大学	辽宁省	沈阳市	本科		
沈阳航空航天大学	辽宁省	沈阳市	本科		
沈阳理工大学	辽宁省	沈阳市	本科		
东北大学	教育部	沈阳市	本科		
辽宁科技大学	辽宁省	鞍山市	本科		
辽宁工程技术大学	辽宁省	阜新市	本科		
辽宁石油化工大学	辽宁省	抚顺市	本科		
沈阳化工大学	辽宁省	沈阳市	本科		
大连交通大学	辽宁省	大连市	本科		
大连海事大学	交通运输部	大连市	本科		
大连工业大学	辽宁省	大连市	本科		
沈阳建筑大学	辽宁省	沈阳市	本科		
辽宁工业大学	辽宁省	锦州市	本科		
沈阳农业大学	辽宁省	沈阳市	本科		
大连海洋大学	辽宁省	大连市	本科		
中国医科大学	辽宁省	沈阳市	本科		
辽宁医学院	辽宁省	锦州市	本科		
大连医科大学	辽宁省	大连市	本科		
辽宁中医药大学	辽宁省	沈阳市	本科		
沈阳药科大学	辽宁省	沈阳市	本科		
沈阳医学院	辽宁省	沈阳市	本科		
辽宁师范大学	辽宁省	大连市	本科		
沈阳师范大学	辽宁省	沈阳市	本科		
渤海大学	辽宁省	锦州市	本科		
鞍山师范学院	辽宁省	鞍山市	本科		
大连外国语大学	辽宁省	大连市	本科		
东北财经大学	辽宁省	大连市	本科		
中国刑事警察学院	公安部	沈阳市	本科		
沈阳体育学院	辽宁省	沈阳市	本科		
沈阳音乐学院	辽宁省	沈阳市	本科		
鲁迅美术学院	辽宁省	沈阳市	本科		
辽宁对外经贸学院	辽宁省教育厅	大连市	本科	民办	
沈阳大学	辽宁省	沈阳市	本科		
大连大学	辽宁省	大连市	本科		
辽宁科技学院	辽宁省	本溪市	本科		
辽宁警察学院	辽宁省	大连市	本科		
沈阳工程学院	辽宁省	沈阳市	本科		
辽东学院	辽宁省	丹东市	本科		
大连民族大学	国家民委	大连市	本科		
大连理工大学城市学院	辽宁省教育厅	大连市	本科	民办	
沈阳工业大学工程学院	辽宁省教育厅	辽阳市	本科	民办	
沈阳航空航天大学北方科技学院	辽宁省教育厅	沈阳市	本科	民办	
沈阳工学院	辽宁省教育厅	沈阳市	本科	民办	
大连工业大学艺术与信息工程学院	辽宁省教育厅	大连市	本科	民办	
大连科技学院	辽宁省教育厅	大连市	本科	民办	
沈阳城市建设学院	辽宁省教育厅	沈阳市	本科	民办	
中国医科大学临床医药学院	辽宁省教育厅	沈阳市	本科	民办	
大连医科大学中山学院	辽宁省教育厅	大连市	本科	民办	
辽宁医学院医疗学院	辽宁省教育厅	锦州市	本科	民办	
辽宁师范大学海华学院	辽宁省教育厅	沈阳市	本科	民办	
辽宁理工学院	辽宁省教育厅	锦州市	本科	民办	
大连财经学院	辽宁省教育厅	大连市	本科	民办	
沈阳城市学院	辽宁省教育厅	沈阳市	本科	民办	
辽宁科技大学信息技术学院	辽宁省教育厅	鞍山市	本科	民办	
辽宁石油化工大学顺华能源学院	辽宁省教育厅	抚顺市	本科	民办	
大连艺术学院	辽宁省教育厅	大连市	本科	民办	
辽宁中医药大学杏林学院	辽宁省教育厅	沈阳市	本科	民办	
辽宁何氏医学院	辽宁省教育厅	沈阳市	本科	民办	
沈阳化工大学科亚学院	辽宁省教育厅	沈阳市	本科	民办	
大连东软信息学院	辽宁省教育厅	大连市	本科	民办	
辽宁财贸学院	辽宁省教育厅	葫芦岛市	本科	民办	
辽宁传媒学院	辽宁省教育厅	沈阳市	本科	民办	
营口理工学院	辽宁省	营口市	本科		
朝阳师范高等专科学校	辽宁省	朝阳市	专科		
抚顺师范高等专科学校	辽宁省	抚顺市	专科		
锦州师范高等专科学校	辽宁省	锦州市	专科		
营口职业技术学院	辽宁省	营口市	专科		
铁岭师范高等专科学校	辽宁省	铁岭市	专科		
大连职业技术学院	辽宁省	大连市	专科		
辽宁农业职业技术学院	辽宁省	营口市	专科		
抚顺职业技术学院	辽宁省	抚顺市	专科		
辽阳职业技术学院	辽宁省	辽阳市	专科		
阜新高等专科学校	辽宁省	阜新市	专科		
辽宁省交通高等专科学校	辽宁省	沈阳市	专科		
辽宁税务高等专科学校	辽宁省	大连市	专科		
盘锦职业技术学院	辽宁省	盘锦市	专科		
沈阳航空职业技术学院	辽宁省	沈阳市	专科		
辽宁体育运动职业技术学院	辽宁省	沈阳市	专科		
辽宁职业学院	辽宁省	铁岭市	专科		
辽宁林业职业技术学院	辽宁省	沈阳市	专科		
沈阳职业技术学院	辽宁省	沈阳市	专科		
辽宁理工职业学院	辽宁省教育厅	锦州市	专科	民办	
大连商务职业学院	辽宁省教育厅	大连市	专科	民办	
辽宁金融职业学院	辽宁省	沈阳市	专科		
辽宁轨道交通职业学院	辽宁省	沈阳市	专科		
辽宁广告职业学院	辽宁省教育厅	沈阳市	专科	民办	
辽宁机电职业技术学院	辽宁省	丹东市	专科		
辽宁经济职业技术学院	辽宁省	沈阳市	专科		
辽宁石化职业技术学院	辽宁省	锦州市	专科		
渤海船舶职业学院	辽宁省	葫芦岛市	专科		
大连软件职业学院	辽宁省教育厅	大连市	专科	民办	
大连翻译职业学院	辽宁省教育厅	大连市	专科	民办	
辽宁商贸职业学院	辽宁省	沈阳市	专科		
大连枫叶职业技术学院	辽宁省教育厅	大连市	专科	民办	
辽宁装备制造职业技术学院	辽宁省	沈阳市	专科		
辽河石油职业技术学院	辽宁省	盘锦市	专科		
辽宁地质工程职业学院	辽宁省	丹东市	专科		
辽宁铁道职业技术学院	辽宁省	锦州市	专科		
辽宁建筑职业学院	辽宁省	辽阳市	专科		
大连航运职业技术学院	辽宁省教育厅	大连市	专科	民办	
大连装备制造职业技术学院	辽宁省教育厅	大连市	专科	民办	
大连汽车职业技术学院	辽宁省教育厅	大连市	专科	民办	
辽宁现代服务职业技术学院	辽宁省	沈阳市	专科		
辽宁冶金职业技术学院	辽宁省	本溪市	专科		
辽宁工程职业学院	辽宁省	铁岭市	专科		
辽宁城市建设职业技术学院	辽宁省	沈阳市	专科		
辽宁医药职业学院	辽宁省	沈阳市	专科		
铁岭卫生职业学院	辽宁省	铁岭市	专科		
沈阳北软信息职业技术学院	辽宁省教育厅	沈阳市	专科	民办	
辽宁政法职业学院	辽宁省	沈阳市	专科		
辽宁民族师范高等专科学校	辽宁省	沈阳市	专科		
辽宁轻工职业学院	辽宁省	大连市	专科		
辽宁水利职业学院	辽宁省	沈阳市	专科		
辽宁特殊教育师范高等专科学校	辽宁省	沈阳市	专科		
吉林大学	教育部	长春市	本科		
延边大学	吉林省	延边朝鲜族
长春理工大学	吉林省	长春市	本科		
东北电力大学	吉林省	吉林市	本科		
长春工业大学	吉林省	长春市	本科		
吉林建筑大学	吉林省	长春市	本科		
吉林化工学院	吉林省	吉林市	本科		
吉林农业大学	吉林省	长春市	本科		
长春中医药大学	吉林省	长春市	本科		
东北师范大学	教育部	长春市	本科		
北华大学	吉林省	吉林市	本科		
通化师范学院	吉林省	通化市	本科		
吉林师范大学	吉林省	四平市	本科		
吉林工程技术师范学院	吉林省	长春市	本科		
长春师范大学	吉林省	长春市	本科		
白城师范学院	吉林省	白城市	本科		
吉林财经大学	吉林省	长春市	本科		
吉林体育学院	吉林省	长春市	本科		
吉林艺术学院	吉林省	长春市	本科		
吉林华桥外国语学院	吉林省教育厅	长春市	本科	民办	
吉林工商学院	吉林省	长春市	本科		
长春工程学院	吉林省	长春市	本科		
吉林农业科技学院	吉林省	吉林市	本科		
吉林警察学院	吉林省	长春市	本科		
长春大学	吉林省	长春市	本科		
长春光华学院	吉林省教育厅	长春市	本科	民办	
长春工业大学人文信息学院	吉林省教育厅	长春市	本科	民办	
长春理工大学光电信息学院	吉林省教育厅	长春市	本科	民办	
长春财经学院	吉林省教育厅	长春市	本科	民办	
吉林建筑大学城建学院	吉林省教育厅	长春市	本科	民办	
长春建筑学院	吉林省教育厅	长春市	本科	民办	
长春科技学院	吉林省教育厅	长春市	本科	民办	
吉林动画学院	吉林省教育厅	长春市	本科	民办	
吉林师范大学博达学院	吉林省教育厅	四平市	本科	民办	
长春大学旅游学院	吉林省教育厅	长春市	本科	民办	
东北师范大学人文学院	吉林省教育厅	长春市	本科	民办	
吉林医药学院	吉林省	吉林市	本科		
辽源职业技术学院	吉林省	辽源市	专科		
四平职业大学	吉林省	四平市	专科		
长春汽车工业高等专科学校	吉林省	长春市	专科		
长春金融高等专科学校	吉林省	长春市	专科		
长春医学高等专科学校	吉林省	长春市	专科		
吉林交通职业技术学院	吉林省	长春市	专科		
长春东方职业学院	吉林省教育厅	长春市	专科	民办	
吉林司法警官职业学院	吉林省	长春市	专科		
吉林电子信息职业技术学院	吉林省	吉林市	专科		
吉林工业职业技术学院	吉林省	吉林市	专科		
吉林工程职业学院	吉林省	四平市	专科		
长春职业技术学院	吉林省	长春市	专科		
白城医学高等专科学校	吉林省	白城市	专科		
长春信息技术职业学院	吉林省教育厅	长春市	专科	民办	
松原职业技术学院	吉林省	松原市	专科		
吉林铁道职业技术学院	吉林省	吉林市	专科		
白城职业技术学院	吉林省	白城市	专科		
长白山职业技术学院	吉林省	白山市	专科		
吉林科技职业技术学院	吉林省教育厅	长春市	专科	民办	
延边职业技术学院	吉林省	延边朝鲜族
吉林城市职业技术学院	吉林省教育厅	长春市	专科	民办	
黑龙江大学	黑龙江省	哈尔滨市	本科		
哈尔滨工业大学	工业和信息化部	哈尔滨市	本科		
哈尔滨理工大学	黑龙江省	哈尔滨市	本科		
哈尔滨工程大学	工业和信息化部	哈尔滨市	本科		
黑龙江科技大学	黑龙江省	哈尔滨市	本科		
东北石油大学	黑龙江省	大庆市	本科		
佳木斯大学	黑龙江省	佳木斯市	本科		
黑龙江八一农垦大学	黑龙江省	大庆市	本科		
东北农业大学	黑龙江省	哈尔滨市	本科		
东北林业大学	教育部	哈尔滨市	本科		
哈尔滨医科大学	黑龙江省	哈尔滨市	本科		
黑龙江中医药大学	黑龙江省	哈尔滨市	本科		
牡丹江医学院	黑龙江省	牡丹江市	本科		
哈尔滨师范大学	黑龙江省	哈尔滨市	本科		
齐齐哈尔大学	黑龙江省	齐齐哈尔市	本科		
牡丹江师范学院	黑龙江省	牡丹江市	本科		
哈尔滨学院	黑龙江省	哈尔滨市	本科		
大庆师范学院	黑龙江省	大庆市	本科		
绥化学院	黑龙江省	绥化市	本科		
哈尔滨商业大学	黑龙江省	哈尔滨市	本科		
哈尔滨体育学院	黑龙江省	哈尔滨市	本科		
哈尔滨金融学院	黑龙江省	哈尔滨市	本科		
齐齐哈尔医学院	黑龙江省	齐齐哈尔市	本科		
黑龙江工业学院	黑龙江省	鸡西市	本科		
黑龙江东方学院	黑龙江省教育厅	哈尔滨市	本科	民办	
哈尔滨信息工程学院	黑龙江省教育厅	哈尔滨市	本科	民办	
黑龙江工程学院	黑龙江省	哈尔滨市	本科		
齐齐哈尔工程学院	黑龙江省教育厅	齐齐哈尔市	本科	民办	
黑龙江外国语学院	黑龙江省教育厅	哈尔滨市	本科	民办	
黑龙江财经学院	黑龙江省教育厅	哈尔滨市	本科	民办	
哈尔滨石油学院	黑龙江省教育厅	哈尔滨市	本科	民办	
黑龙江工商学院	黑龙江省教育厅	哈尔滨市	本科	民办	
哈尔滨远东理工学院	黑龙江省教育厅	哈尔滨市	本科	民办	
哈尔滨剑桥学院	黑龙江省教育厅	哈尔滨市	本科	民办	
黑龙江工程学院昆仑旅游学院	黑龙江省教育厅	哈尔滨市	本科	民办	
哈尔滨广厦学院	黑龙江省教育厅	哈尔滨市	本科	民办	
哈尔滨华德学院	黑龙江省教育厅	哈尔滨市	本科	民办	
黑河学院	黑龙江省	黑河市	本科		
齐齐哈尔高等师范专科学校	黑龙江省	齐齐哈尔市	专科		
伊春职业学院	黑龙江省	伊春市	专科		
牡丹江大学	黑龙江省	牡丹江市	专科		
黑龙江职业学院	黑龙江省	哈尔滨市	专科		
黑龙江建筑职业技术学院	黑龙江省	哈尔滨市	专科		
黑龙江艺术职业学院	黑龙江省	哈尔滨市	专科		
大庆职业学院	黑龙江省	大庆市	专科		
黑龙江林业职业技术学院	黑龙江省	牡丹江市	专科		
黑龙江农业职业技术学院	黑龙江省	佳木斯市	专科		
黑龙江农业工程职业学院	黑龙江省	哈尔滨市	专科		
黑龙江农垦职业学院	黑龙江省	哈尔滨市	专科		
黑龙江司法警官职业学院	黑龙江省	哈尔滨市	专科		
鹤岗师范高等专科学校	黑龙江省	鹤岗市	专科		
哈尔滨电力职业技术学院	黑龙江省	哈尔滨市	专科		
哈尔滨铁道职业技术学院	黑龙江省	哈尔滨市	专科		
大兴安岭职业学院	黑龙江省	大兴安岭
黑龙江农业经济职业学院	黑龙江省	牡丹江市	专科		
哈尔滨职业技术学院	黑龙江省	哈尔滨市	专科		
哈尔滨传媒职业学院	黑龙江省教育厅	哈尔滨市	专科	民办	
黑龙江生物科技职业学院	黑龙江省	哈尔滨市	专科		
黑龙江商业职业学院	黑龙江省	牡丹江市	专科		
黑龙江公安警官职业学院	黑龙江省	哈尔滨市	专科		
黑龙江信息技术职业学院	黑龙江省	哈尔滨市	专科		
哈尔滨江南职业技术学院	黑龙江省教育厅	哈尔滨市	专科	民办	
黑龙江农垦科技职业学院	黑龙江省	哈尔滨市	专科		
黑龙江旅游职业技术学院	黑龙江省	哈尔滨市	专科		
黑龙江三江美术职业学院	黑龙江省教育厅	佳木斯市	专科	民办	
黑龙江生态工程职业学院	黑龙江省	哈尔滨市	专科		
黑龙江煤炭职业技术学院	黑龙江省	双鸭山市	专科		
七台河职业学院	黑龙江省	七台河市	专科		
黑龙江民族职业学院	黑龙江省	哈尔滨市	专科		
大庆医学高等专科学校	黑龙江省	大庆市	专科		
黑龙江交通职业技术学院	黑龙江省	齐齐哈尔市	专科		
哈尔滨应用职业技术学院	黑龙江省教育厅	哈尔滨市	专科	民办	
黑龙江幼儿师范高等专科学校	黑龙江省	牡丹江市	专科		
哈尔滨科学技术职业学院	黑龙江省	哈尔滨市	专科		
黑龙江粮食职业学院	黑龙江省	哈尔滨市	专科		
佳木斯职业学院	黑龙江省	佳木斯市	专科		
黑龙江护理高等专科学校	黑龙江省	哈尔滨市	专科		
哈尔滨工程技术职业学院	黑龙江省教育厅	哈尔滨市	专科	民办	
齐齐哈尔理工职业学院	黑龙江省教育厅	齐齐哈尔市	专科	民办	
哈尔滨幼儿师范高等专科学校	黑龙江省	哈尔滨市	专科		
黑龙江冰雪体育职业学院	黑龙江省	哈尔滨市	专科		
复旦大学	教育部	上海市	本科		
同济大学	教育部	上海市	本科		
上海交通大学	教育部	上海市	本科		
华东理工大学	教育部	上海市	本科		
上海理工大学	上海市	上海市	本科		
上海海事大学	上海市	上海市	本科		
东华大学	教育部	上海市	本科		
上海电力学院	上海市	上海市	本科		
上海应用技术学院	上海市	上海市	本科		
上海健康医学院	上海市	上海市	本科		
上海海洋大学	上海市	上海市	本科		
上海中医药大学	上海市	上海市	本科		
华东师范大学	教育部	上海市	本科		
上海师范大学	上海市	上海市	本科		
上海外国语大学	教育部	上海市	本科		
上海财经大学	教育部	上海市	本科		
上海对外经贸大学	上海市	上海市	本科		
上海海关学院	海关总署	上海市	本科		
华东政法大学	上海市	上海市	本科		
上海体育学院	上海市	上海市	本科		
上海音乐学院	上海市	上海市	本科		
上海戏剧学院	上海市	上海市	本科		
上海大学	上海市	上海市	本科		
上海工程技术大学	上海市	上海市	本科		
上海立信会计学院	上海市	上海市	本科		
上海电机学院	上海市	上海市	本科		
上海金融学院	上海市	上海市	本科		
上海杉达学院	上海市教委	上海市	本科	民办	
上海政法学院	上海市	上海市	本科		
上海第二工业大学	上海市	上海市	本科		
上海商学院	上海市	上海市	本科		
上海建桥学院	上海市教委	上海市	本科	民办	
上海兴伟学院	上海市教委	上海市	本科	民办	
上海视觉艺术学院	上海市教委	上海市	本科	民办	
上海外国语大学贤达经济人文学院	上海市教委	上海市	本科	民办	
上海师范大学天华学院	上海市教委	上海市	本科	民办	
上海科技大学	上海市 中国科学院	上海市	本科		
上海纽约大学	上海市教委	上海市	本科	中外合作办学	
上海旅游高等专科学校	上海市	上海市	专科		
上海公安高等专科学校	上海市	上海市	专科		
上海东海职业技术学院	上海市教委	上海市	专科	民办	
上海工商职业技术学院	上海市教委	上海市	专科	民办	
上海出版印刷高等专科学校	上海市	上海市	专科		
上海行健职业学院	上海市	上海市	专科		
上海城市管理职业技术学院	上海市	上海市	专科		
上海交通职业技术学院	上海市	上海市	专科		
上海海事职业技术学院	上海市	上海市	专科		
上海电子信息职业技术学院	上海市	上海市	专科		
上海震旦职业学院	上海市教委	上海市	专科	民办	
上海民远职业技术学院	上海市教委	上海市	专科	民办	
上海欧华职业技术学院	上海市教委	上海市	专科	民办	
上海思博职业技术学院	上海市教委	上海市	专科	民办	
上海立达职业技术学院	上海市教委	上海市	专科	民办	
上海工艺美术职业学院	上海市	上海市	专科		
上海济光职业技术学院	上海市教委	上海市	专科	民办	
上海工商外国语职业学院	上海市教委	上海市	专科	民办	
上海科学技术职业学院	上海市	上海市	专科		
上海农林职业技术学院	上海市	上海市	专科		
上海邦德职业技术学院	上海市教委	上海市	专科	民办	
上海中侨职业技术学院	上海市教委	上海市	专科	民办	
上海建峰职业技术学院	上海市	上海市	专科		
上海电影艺术职业学院	上海市教委	上海市	专科	民办	
上海中华职业技术学院	上海市教委	上海市	专科	民办	
上海工会管理职业学院	上海市	上海市	专科		
上海体育职业学院	上海市	上海市	专科		
上海健康职业技术学院	上海市	上海市	专科		
上海民航职业技术学院	交通运输部	上海市	专科		
南京大学	教育部	南京市	本科		
苏州大学	江苏省	苏州市	本科		
东南大学	教育部	南京市	本科		
南京航空航天大学	工业和信息化部	南京市	本科		
南京理工大学	工业和信息化部	南京市	本科		
江苏科技大学	江苏省	镇江市	本科		
中国矿业大学	教育部	徐州市	本科		
南京工业大学	江苏省	南京市	本科		
常州大学	江苏省	常州市	本科		
南京邮电大学	江苏省	南京市	本科		
河海大学	教育部	南京市	本科		
江南大学	教育部	无锡市	本科		
南京林业大学	江苏省	南京市	本科		
江苏大学	江苏省	镇江市	本科		
南京信息工程大学	江苏省	南京市	本科		
南通大学	江苏省	南通市	本科		
盐城工学院	江苏省	盐城市	本科		
南京农业大学	教育部	南京市	本科		
南京医科大学	江苏省	南京市	本科		
徐州医学院	江苏省	徐州市	本科		
南京中医药大学	江苏省	南京市	本科		
中国药科大学	教育部	南京市	本科		
南京师范大学	江苏省	南京市	本科		
江苏师范大学	江苏省	徐州市	本科		
淮阴师范学院	江苏省	淮安市	本科		
盐城师范学院	江苏省	盐城市	本科		
南京财经大学	江苏省	南京市	本科		
江苏警官学院	江苏省	南京市	本科		
南京体育学院	江苏省	南京市	本科		
南京艺术学院	江苏省	南京市	本科		
苏州科技学院	江苏省	苏州市	本科		
常熟理工学院	江苏省	苏州市	本科		
淮阴工学院	江苏省	淮安市	本科		
常州工学院	江苏省	常州市	本科		
扬州大学	江苏省	扬州市	本科		
三江学院	江苏省教育厅	南京市	本科	民办	
南京工程学院	江苏省	南京市	本科		
南京审计学院	江苏省	南京市	本科		
南京晓庄学院	江苏省	南京市	本科		
江苏理工学院	江苏省	常州市	本科		
淮海工学院	江苏省	连云港市	本科		
徐州工程学院	江苏省	徐州市	本科		
南京特殊教育师范学院	江苏省	南京市	本科		
南通理工学院	江苏省教育厅	南通市	本科	民办	
南京森林警察学院	国家林业局	南京市	本科		
东南大学成贤学院	江苏省教育厅	南京市	本科	民办	
泰州学院	江苏省	泰州市	本科		
无锡太湖学院	江苏省教育厅	无锡市	本科	民办	
金陵科技学院	江苏省	南京市	本科		
中国矿业大学徐海学院	江苏省教育厅	徐州市	本科	民办	
南京大学金陵学院	江苏省教育厅	南京市	本科	民办	
南京理工大学紫金学院	江苏省教育厅	南京市	本科	民办	
南京航空航天大学金城学院	江苏省教育厅	南京市	本科	民办	
中国传媒大学南广学院	江苏省教育厅	南京市	本科	民办	
南京理工大学泰州科技学院	江苏省教育厅	泰州市	本科	民办	
南京师范大学泰州学院	江苏省教育厅	泰州市	本科	民办	
南京工业大学浦江学院	江苏省教育厅	南京市	本科	民办	
南京师范大学中北学院	江苏省教育厅	南京市	本科	民办	
南京医科大学康达学院	江苏省教育厅	连云港市	本科	民办	
南京中医药大学翰林学院	江苏省教育厅	泰州市	本科	民办	
南京信息工程大学滨江学院	江苏省教育厅	南京市	本科	民办	
苏州大学文正学院	江苏省教育厅	苏州市	本科	民办	
苏州大学应用技术学院	江苏省教育厅	苏州市	本科	民办	
苏州科技学院天平学院	江苏省教育厅	苏州市	本科	民办	
江苏大学京江学院	江苏省教育厅	镇江市	本科	民办	
扬州大学广陵学院	江苏省教育厅	扬州市	本科	民办	
江苏师范大学科文学院	江苏省教育厅	徐州市	本科	民办	
南京邮电大学通达学院	江苏省教育厅	扬州市	本科	民办	
南京财经大学红山学院	江苏省教育厅	镇江市	本科	民办	
江苏科技大学苏州理工学院	江苏省教育厅	张家港市	本科	民办	
常州大学怀德学院	江苏省教育厅	泰州市	本科	民办	
南通大学杏林学院	江苏省教育厅	南通市	本科	民办	
南京审计学院金审学院	江苏省教育厅	南京市	本科	民办	
宿迁学院	江苏省教育厅	宿迁市	本科	民办	
江苏第二师范学院	江苏省	南京市	本科		
西交利物浦大学	江苏省教育厅	苏州市	本科	中外合作办学	
昆山杜克大学	江苏省教育厅	苏州市	本科	中外合作办学	
民办明达职业技术学院	江苏省教育厅	盐城市	专科	民办	
无锡职业技术学院	江苏省	无锡市	专科		
江苏建筑职业技术学院	江苏省	徐州市	专科		
南京工业职业技术学院	江苏省	南京市	专科		
江苏工程职业技术学院	江苏省	南通市	专科		
苏州工艺美术职业技术学院	江苏省	苏州市	专科		
连云港职业技术学院	江苏省	连云港市	专科		
镇江市高等专科学校	江苏省	镇江市	专科		
南通职业大学	江苏省	南通市	专科		
苏州职业大学	江苏省	苏州市	专科		
沙洲职业工学院	江苏省	苏州市	专科		
扬州市职业大学	江苏省	扬州市	专科		
连云港师范高等专科学校	江苏省	连云港市	专科		
江苏经贸职业技术学院	江苏省	南京市	专科		
九州职业技术学院	江苏省教育厅	徐州市	专科	民办	
硅湖职业技术学院	江苏省教育厅	苏州市	专科	民办	
泰州职业技术学院	江苏省	泰州市	专科		
常州信息职业技术学院	江苏省	常州市	专科		
江苏联合职业技术学院	江苏省	南京市	专科		
江苏海事职业技术学院	江苏省	南京市	专科		
应天职业技术学院	江苏省教育厅	南京市	专科	民办	
无锡科技职业学院	江苏省	无锡市	专科		
盐城卫生职业技术学院	江苏省	盐城市	专科		
扬州环境资源职业技术学院	江苏省	扬州市	专科		
南通科技职业学院	江苏省	南通市	专科		
苏州经贸职业技术学院	江苏省	苏州市	专科		
苏州工业职业技术学院	江苏省	苏州市	专科		
苏州托普信息职业技术学院	江苏省教育厅	苏州市	专科	民办	
苏州卫生职业技术学院	江苏省	苏州市	专科		
无锡商业职业技术学院	江苏省	无锡市	专科		
南通航运职业技术学院	江苏省	南通市	专科		
南京交通职业技术学院	江苏省	南京市	专科		
淮安信息职业技术学院	江苏省	淮安市	专科		
江苏农牧科技职业学院	江苏省	泰州市	专科		
常州纺织服装职业技术学院	江苏省	常州市	专科		
苏州农业职业技术学院	江苏省	苏州市	专科		
苏州工业园区职业技术学院	江苏省	苏州市	专科		
太湖创意职业技术学院	江苏省教育厅	无锡市	专科	民办	
炎黄职业技术学院	江苏省教育厅	淮安市	专科	民办	
南京科技职业学院	江苏省	南京市	专科		
正德职业技术学院	江苏省教育厅	南京市	专科	民办	
钟山职业技术学院	江苏省教育厅	南京市	专科	民办	
无锡南洋职业技术学院	江苏省教育厅	无锡市	专科	民办	
江南影视艺术职业学院	江苏省教育厅	无锡市	专科	民办	
金肯职业技术学院	江苏省教育厅	南京市	专科	民办	
常州轻工职业技术学院	江苏省	常州市	专科		
常州工程职业技术学院	江苏省	常州市	专科		
江苏农林职业技术学院	江苏省	镇江市	专科		
江苏食品药品职业技术学院	江苏省	淮安市	专科		
建东职业技术学院	江苏省教育厅	常州市	专科	民办	
南京铁道职业技术学院	江苏省	南京市	专科		
徐州工业职业技术学院	江苏省	徐州市	专科		
江苏信息职业技术学院	江苏省	无锡市	专科		
宿迁职业技术学院	江苏省	宿迁市	专科		
南京信息职业技术学院	江苏省	南京市	专科		
江海职业技术学院	江苏省教育厅	扬州市	专科	民办	
常州机电职业技术学院	江苏省	常州市	专科		
江阴职业技术学院	江苏省	无锡市	专科		
无锡城市职业技术学院	江苏省	无锡市	专科		
无锡工艺职业技术学院	江苏省	无锡市	专科		
金山职业技术学院	江苏省教育厅	镇江市	专科	民办	
苏州健雄职业技术学院	江苏省	苏州市	专科		
盐城工业职业技术学院	江苏省	盐城市	专科		
江苏财经职业技术学院	江苏省	淮安市	专科		
扬州工业职业技术学院	江苏省	扬州市	专科		
苏州港大思培科技职业学院	江苏省教育厅	苏州市	专科	民办	
昆山登云科技职业学院	江苏省教育厅	苏州市	专科	民办	
南京视觉艺术职业学院	江苏省教育厅	南京市	专科	民办	
江苏城市职业学院	江苏省	南京市	专科		
南京城市职业学院	江苏省	南京市	专科		
南京机电职业技术学院	江苏省	南京市	专科		
苏州高博软件技术职业学院	江苏省教育厅	苏州市	专科	民办	
南京旅游职业学院	江苏省	南京市	专科		
江苏建康职业学院	江苏省	南京市	专科		
苏州信息职业技术学院	江苏省	苏州市	专科		
宿迁泽达职业技术学院	江苏省教育厅	宿迁市	专科	民办	
苏州工业园区服务外包职业学院	江苏省	苏州市	专科		
徐州幼儿师范高等专科学校	江苏省	徐州市	专科		
徐州生物工程职业技术学院	江苏省	徐州市	专科		
江苏商贸职业学院	江苏省	南通市	专科		
南通师范高等专科学校	江苏省	南通市	专科		
扬州中瑞酒店职业学院	江苏省教育厅	扬州市	专科	民办	
江苏护理职业学院	江苏省	淮安市	专科		
江苏财会职业学院	江苏省	连云港市	专科		
江苏城乡建设职业学院	江苏省	常州市	专科		
浙江大学	教育部	杭州市	本科		
杭州电子科技大学	浙江省	杭州市	本科		
浙江工业大学	浙江省	杭州市	本科		
浙江理工大学	浙江省	杭州市	本科		
浙江海洋学院	浙江省	舟山市	本科		
浙江农林大学	浙江省	杭州市	本科		
温州医科大学	浙江省	温州市	本科		
浙江中医药大学	浙江省	杭州市	本科		
浙江师范大学	浙江省	金华市	本科		
杭州师范大学	浙江省	杭州市	本科		
湖州师范学院	浙江省	湖州市	本科		
绍兴文理学院	浙江省	绍兴市	本科		
台州学院	浙江省	台州市	本科		
温州大学	浙江省	温州市	本科		
丽水学院	浙江省	丽水市	本科		
浙江工商大学	浙江省	杭州市	本科		
嘉兴学院	浙江省	嘉兴市	本科		
中国美术学院	浙江省	杭州市	本科		
中国计量学院	浙江省	杭州市	本科		
公安海警学院	公安部	宁波市	本科		
浙江万里学院	浙江省	宁波市	本科		
浙江科技学院	浙江省	杭州市	本科		
宁波工程学院	浙江省	宁波市	本科		
浙江水利水电学院	浙江省	杭州市	本科		
浙江财经大学	浙江省	杭州市	本科		
浙江警察学院	浙江省	杭州市	本科		
衢州学院	浙江省	衢州市	本科		
宁波大学	浙江省	宁波市	本科		
浙江传媒学院	浙江省	杭州市	本科		
浙江树人学院	浙江省教育厅	杭州市	本科	民办	
浙江越秀外国语学院	浙江省教育厅	绍兴市	本科	民办	
宁波大红鹰学院	浙江省教育厅	宁波市	本科	民办	
浙江大学城市学院	浙江省教育厅	杭州市	本科	民办	
浙江大学宁波理工学院	浙江省教育厅	宁波市	本科	民办	
浙江工业大学之江学院	浙江省教育厅	杭州市	本科	民办	
浙江师范大学行知学院	浙江省教育厅	金华市	本科	民办	
宁波大学科学技术学院	浙江省教育厅	宁波市	本科	民办	
杭州电子科技大学信息工程学院	浙江省教育厅	杭州市	本科	民办	
浙江理工大学科技与艺术学院	浙江省教育厅	杭州市	本科	民办	
浙江海洋学院东海科学技术学院	浙江省教育厅	舟山市	本科	民办	
浙江农林大学暨阳学院	浙江省教育厅	绍兴市	本科	民办	
温州医科大学仁济学院	浙江省教育厅	温州市	本科	民办	
浙江中医药大学滨江学院	浙江省教育厅	杭州市	本科	民办	
杭州师范大学钱江学院	浙江省教育厅	杭州市	本科	民办	
湖州师范学院求真学院	浙江省教育厅	湖州市	本科	民办	
绍兴文理学院元培学院	浙江省教育厅	绍兴市	本科	民办	
温州大学瓯江学院	浙江省教育厅	温州市	本科	民办	
浙江工商大学杭州商学院	浙江省教育厅	杭州市	本科	民办	
嘉兴学院南湖学院	浙江省教育厅	嘉兴市	本科	民办	
中国计量学院现代科技学院	浙江省教育厅	杭州市	本科	民办	
浙江财经大学东方学院	浙江省教育厅	嘉兴市	本科	民办	
温州大学城市学院	浙江省教育厅	温州市	本科	民办	
同济大学浙江学院	浙江省教育厅	嘉兴市	本科	民办	
上海财经大学浙江学院	浙江省教育厅	金华市	本科	民办	
浙江外国语学院	浙江省	杭州市	本科		
宁波诺丁汉大学	浙江省教育厅	宁波市	本科	中外合作办学	
温州肯恩大学	浙江省教育厅	温州市	本科	中外合作办学	
宁波职业技术学院	浙江省	宁波市	专科		
温州职业技术学院	浙江省	温州市	专科		
浙江交通职业技术学院	浙江省	杭州市	专科		
金华职业技术学院	浙江省	金华市	专科		
宁波城市职业技术学院	浙江省	宁波市	专科		
浙江电力职业技术学院	浙江省	杭州市	专科		
浙江同济科技职业学院	浙江省	杭州市	专科		
浙江工商职业技术学院	浙江省	宁波市	专科		
台州职业技术学院	浙江省	台州市	专科		
浙江工贸职业技术学院	浙江省	温州市	专科		
浙江医药高等专科学校	浙江省	宁波市	专科		
浙江机电职业技术学院	浙江省	杭州市	专科		
浙江建设职业技术学院	浙江省	杭州市	专科		
浙江艺术职业学院	浙江省	杭州市	专科		
浙江经贸职业技术学院	浙江省	杭州市	专科		
浙江商业职业技术学院	浙江省	杭州市	专科		
浙江经济职业技术学院	浙江省	杭州市	专科		
浙江旅游职业学院	浙江省	杭州市	专科		
浙江育英职业技术学院	浙江省教育厅	杭州市	专科	民办	
浙江警官职业学院	浙江省	杭州市	专科		
浙江金融职业学院	浙江省	杭州市	专科		
浙江工业职业技术学院	浙江省	绍兴市	专科		
杭州职业技术学院	浙江省	杭州市	专科		
嘉兴职业技术学院	浙江省	嘉兴市	专科		
湖州职业技术学院	浙江省	湖州市	专科		
绍兴职业技术学院	浙江省教育厅	绍兴市	专科	民办	
衢州职业技术学院	浙江省	衢州市	专科		
丽水职业技术学院	浙江省	丽水市	专科		
浙江东方职业技术学院	浙江省教育厅	温州市	专科	民办	
义乌工商职业技术学院	浙江省	金华市	专科		
浙江医学高等专科学校	浙江省	杭州市	专科		
浙江纺织服装职业技术学院	浙江省	宁波市	专科		
杭州科技职业技术学院	浙江省	杭州市	专科		
浙江长征职业技术学院	浙江省教育厅	杭州市	专科	民办	
嘉兴南洋职业技术学院	浙江省教育厅	嘉兴市	专科	民办	
浙江广厦建设职业技术学院	浙江省教育厅	金华市	专科	民办	
杭州万向职业技术学院	浙江省教育厅	杭州市	专科	民办	
浙江邮电职业技术学院	浙江省	绍兴市	专科		
宁波卫生职业技术学院	浙江省	宁波市	专科		
台州科技职业学院	浙江省	台州市	专科		
浙江国际海运职业技术学院	浙江省	舟山市	专科		
浙江体育职业技术学院	浙江省	杭州市	专科		
温州科技职业学院	浙江省	温州市	专科		
浙江汽车职业技术学院	浙江省教育厅	台州市	专科	民办	
浙江横店影视职业学院	浙江省教育厅	金华市	专科	民办	
浙江农业商贸职业学院	浙江省	绍兴市	专科		
浙江特殊教育职业学院	浙江省	杭州市	专科		
浙江舟山群岛新区旅游与健康职业学院	浙江省	舟山市	专科		
安徽大学	安徽省	合肥市	本科		
中国科学技术大学	中国科学院	合肥市	本科		
合肥工业大学	教育部	合肥市	本科		
安徽工业大学	安徽省	马鞍山市	本科		
安徽理工大学	安徽省	淮南市	本科		
安徽工程大学	安徽省	芜湖市	本科		
安徽农业大学	安徽省	合肥市	本科		
安徽医科大学	安徽省	合肥市	本科		
蚌埠医学院	安徽省	蚌埠市	本科		
皖南医学院	安徽省	芜湖市	本科		
安徽中医药大学	安徽省	合肥市	本科		
安徽师范大学	安徽省	芜湖市	本科		
阜阳师范学院	安徽省	阜阳市	本科		
安庆师范学院	安徽省	安庆市	本科		
淮北师范大学	安徽省	淮北市	本科		
黄山学院	安徽省	黄山市	本科		
皖西学院	安徽省	六安市	本科		
滁州学院	安徽省	滁州市	本科		
安徽财经大学	安徽省	蚌埠市	本科		
宿州学院	安徽省	宿州市	本科		
巢湖学院	安徽省	合肥市	本科		
淮南师范学院	安徽省	淮南市	本科		
铜陵学院	安徽省	铜陵市	本科		
安徽建筑大学	安徽省	合肥市	本科		
安徽科技学院	安徽省	滁州市	本科		
安徽三联学院	安徽省教育厅	合肥市	本科	民办	
合肥学院	安徽省	合肥市	本科		
蚌埠学院	安徽省	蚌埠市	本科		
池州学院	安徽省	池州市	本科		
安徽新华学院	安徽省教育厅	合肥市	本科	民办	
安徽文达信息工程学院	安徽省教育厅	合肥市	本科	民办	
安徽外国语学院	安徽省教育厅	合肥市	本科	民办	
安徽财经大学商学院	安徽省教育厅	蚌埠市	本科	民办	
安徽大学江淮学院	安徽省教育厅	合肥市	本科	民办	
安徽工程大学机电学院	安徽省教育厅	芜湖市	本科	民办	
安徽工业大学工商学院	安徽省教育厅	马鞍山市	本科	民办	
安徽建筑大学城市建设学院	安徽省教育厅	合肥市	本科	民办	
安徽农业大学经济技术学院	安徽省教育厅	合肥市	本科	民办	
安徽师范大学皖江学院	安徽省教育厅	芜湖市	本科	民办	
安徽医科大学临床医学院	安徽省教育厅	合肥市	本科	民办	
阜阳师范学院信息工程学院	安徽省教育厅	阜阳市	本科	民办	
淮北师范大学信息学院	安徽省教育厅	淮北市	本科	民办	
合肥师范学院	安徽省	合肥市	本科		
河海大学文天学院	安徽省教育厅	马鞍山市	本科	民办	
安徽职业技术学院	安徽省	合肥市	专科		
淮北职业技术学院	安徽省	淮北市	专科		
芜湖职业技术学院	安徽省	芜湖市	专科		
淮南联合大学	安徽省	淮南市	专科		
安徽商贸职业技术学院	安徽省	芜湖市	专科		
安徽水利水电职业技术学院	安徽省	合肥市	专科		
阜阳职业技术学院	安徽省	阜阳市	专科		
铜陵职业技术学院	安徽省	铜陵市	专科		
民办万博科技职业学院	安徽省教育厅	合肥市	专科	民办	
安徽警官职业学院	安徽省	合肥市	专科		
淮南职业技术学院	安徽省	淮南市	专科		
安徽工业经济职业技术学院	安徽省	合肥市	专科		
合肥通用职业技术学院	安徽省	合肥市	专科		
安徽工贸职业技术学院	安徽省	淮南市	专科		
宿州职业技术学院	安徽省	宿州市	专科		
六安职业技术学院	安徽省	六安市	专科		
安徽电子信息职业技术学院	安徽省	蚌埠市	专科		
民办合肥经济技术职业学院	安徽省教育厅	合肥市	专科	民办	
安徽交通职业技术学院	安徽省	合肥市	专科		
安徽体育运动职业技术学院	安徽省	合肥市	专科		
安徽中医药高等专科学校	安徽省	芜湖市	专科		
安徽医学高等专科学校	安徽省	合肥市	专科		
亳州师范高等专科学校	安徽省	亳州市	专科		
合肥职业技术学院	安徽省	合肥市	专科		
滁州职业技术学院	安徽省	滁州市	专科		
池州职业技术学院	安徽省	池州市	专科		
宣城职业技术学院	安徽省	宣城市	专科		
安徽广播影视职业技术学院	安徽省	合肥市	专科		
民办合肥滨湖职业技术学院	安徽省教育厅	合肥市	专科	民办	
安徽电气工程职业技术学院	安徽省	合肥市	专科		
安徽冶金科技职业学院	安徽省	马鞍山市	专科		
安徽城市管理职业学院	安徽省	合肥市	专科		
安徽机电职业技术学院	安徽省	芜湖市	专科		
安徽工商职业学院	安徽省	合肥市	专科		
安徽中澳科技职业学院	安徽省	合肥市	专科		
阜阳科技职业学院	安徽省教育厅	阜阳市	专科	民办	
亳州职业技术学院	安徽省	亳州市	专科		
安徽国防科技职业学院	安徽省	六安市	专科		
安庆职业技术学院	安徽省	安庆市	专科		
安徽艺术职业学院	安徽省	合肥市	专科		
马鞍山师范高等专科学校	安徽省	马鞍山市	专科		
安徽财贸职业学院	安徽省	合肥市	专科		
安徽国际商务职业学院	安徽省	合肥市	专科		
安徽公安职业学院	安徽省	合肥市	专科		
安徽林业职业技术学院	安徽省	合肥市	专科		
安徽审计职业学院	安徽省	合肥市	专科		
安徽新闻出版职业技术学院	安徽省	合肥市	专科		
安徽邮电职业技术学院	安徽省	合肥市	专科		
安徽工业职业技术学院	安徽省	铜陵市	专科		
民办合肥财经职业学院	安徽省教育厅	合肥市	专科	民办	
安庆医药高等专科学校	安徽省	安庆市	专科		
安徽涉外经济职业学院	安徽省教育厅	合肥市	专科	民办	
安徽绿海商务职业学院	安徽省教育厅	合肥市	专科	民办	
合肥共达职业技术学院	安徽省教育厅	合肥市	专科	民办	
蚌埠经济技术职业学院	安徽省教育厅	蚌埠市	专科	民办	
民办安徽旅游职业学院	安徽省教育厅	阜阳市	专科	民办	
徽商职业学院	安徽省	合肥市	专科		
马鞍山职业技术学院	安徽省	马鞍山市	专科		
安徽现代信息工程职业学院	安徽省教育厅	六安市	专科	民办	
安徽矿业职业技术学院	安徽省教育厅	淮北市	专科	民办	
合肥信息技术职业学院	安徽省教育厅	合肥市	专科	民办	
桐城师范高等专科学校	安徽省	安庆市	专科		
黄山职业技术学院	安徽省	黄山市	专科		
滁州城市职业学院	安徽省	滁州市	专科		
安徽汽车职业技术学院	安徽省	合肥市	专科		
皖西卫生职业学院	安徽省	六安市	专科		
合肥幼儿师范高等专科学校	安徽省	合肥市	专科		
安徽长江职业学院	安徽省教育厅	合肥市	专科	民办	
安徽扬子职业技术学院	安徽省教育厅	芜湖市	专科	民办	
安徽黄梅戏艺术职业学院	安徽省	安庆市	专科		
安徽粮食工程职业学院	安徽省	合肥市	专科		
安徽人口职业学院	安徽省	池州市	专科		
合肥科技职业学院	安徽省教育厅	合肥市	专科	民办	
皖北卫生职业学院	安徽省	宿州市	专科		
阜阳幼儿师范高等专科学校	安徽省	阜阳市	专科		
厦门大学	教育部	厦门市	本科		
华侨大学	国务院侨办	泉州市	本科		
福州大学	福建省	福州市	本科		
福建工程学院	福建省	福州市	本科		
福建农林大学	福建省	福州市	本科		
集美大学	福建省	厦门市	本科		
福建医科大学	福建省	福州市	本科		
福建中医药大学	福建省	福州市	本科		
福建师范大学	福建省	福州市	本科		
闽江学院	福建省	福州市	本科		
武夷学院	福建省	南平市	本科		
宁德师范学院	福建省	宁德市	本科		
泉州师范学院	福建省	泉州市	本科		
闽南师范大学	福建省	漳州市	本科		
厦门理工学院	福建省	厦门市	本科		
三明学院	福建省	三明市	本科		
龙岩学院	福建省	龙岩市	本科		
福建警察学院	福建省	福州市	本科		
莆田学院	福建省	莆田市	本科		
仰恩大学	福建省教育厅	泉州市	本科	民办	
厦门华厦学院	福建省教育厅	厦门市	本科	民办	
闽南理工学院	福建省教育厅	泉州市	本科	民办	
福建师范大学闽南科技学院	福建省教育厅	泉州市	本科	民办	
福建农林大学东方学院	福建省教育厅	福州市	本科	民办	
厦门工学院	福建省教育厅	厦门市	本科	民办	
阳光学院	福建省教育厅	福州市	本科	民办	
厦门大学嘉庚学院	福建省教育厅	漳州市	本科	民办	
福州大学至诚学院	福建省教育厅	福州市	本科	民办	
集美大学诚毅学院	福建省教育厅	厦门市	本科	民办	
福建师范大学协和学院	福建省教育厅	福州市	本科	民办	
福州外语外贸学院	福建省教育厅	福州市	本科	民办	
福建江夏学院	福建省	福州市	本科		
泉州信息工程学院	福建省教育厅	泉州市	本科	民办	
福州理工学院	福建省教育厅	福州市	本科	民办	
福建农林大学金山学院	福建省教育厅	福州市	本科	民办	
福建船政交通职业学院	福建省	福州市	专科		
福建商业高等专科学校	福建省	福州市	专科		
漳州职业技术学院	福建省	漳州市	专科		
闽西职业技术学院	福建省	龙岩市	专科		
黎明职业大学	福建省	泉州市	专科		
福建华南女子职业学院	福建省教育厅	福州市	专科	民办	
福州职业技术学院	福建省	福州市	专科		
福建林业职业技术学院	福建省	南平市	专科		
福建信息职业技术学院	福建省	福州市	专科		
福建水利电力职业技术学院	福建省	三明市	专科		
福建电力职业技术学院	福建省	泉州市	专科		
厦门海洋职业技术学院	福建省	厦门市	专科		
福建农业职业技术学院	福建省	福州市	专科		
厦门医学高等专科学校	福建省	厦门市	专科		
福建卫生职业技术学院	福建省	福州市	专科		
泉州医学高等专科学校	福建省	泉州市	专科		
福州英华职业学院	福建省教育厅	福州市	专科	民办	
泉州纺织服装职业学院	福建省教育厅	泉州市	专科	民办	
泉州华光职业学院	福建省教育厅	泉州市	专科	民办	
泉州理工职业学院	福建省教育厅	泉州市	专科	民办	
福建警官职业学院	福建省	福州市	专科		
闽北职业技术学院	福建省	南平市	专科		
福州黎明职业技术学院	福建省教育厅	福州市	专科	民办	
厦门演艺职业学院	福建省教育厅	厦门市	专科	民办	
厦门华天涉外职业技术学院	福建省教育厅	厦门市	专科	民办	
福州科技职业技术学院	福建省教育厅	福州市	专科	民办	
泉州经贸职业技术学院	福建省	泉州市	专科		
福建对外经济贸易职业技术学院	福建省	福州市	专科		
湄洲湾职业技术学院	福建省	莆田市	专科		
福建生物工程职业技术学院	福建省	福州市	专科		
福建艺术职业学院	福建省	福州市	专科		
福建幼儿师范高等专科学校	福建省	福州市	专科		
厦门城市职业学院	福建省	厦门市	专科		
泉州工艺美术职业学院	福建省	泉州市	专科		
三明职业技术学院	福建省	三明市	专科		
宁德职业技术学院	福建省	宁德市	专科		
福州软件职业技术学院	福建省教育厅	福州市	专科	民办	
厦门兴才职业技术学院	福建省教育厅	厦门市	专科	民办	
厦门软件职业技术学院	福建省教育厅	厦门市	专科	民办	
福建体育职业技术学院	福建省	福州市	专科		
漳州城市职业学院	福建省	漳州市	专科		
厦门南洋职业学院	福建省教育厅	厦门市	专科	民办	
厦门东海职业技术学院	福建省教育厅	厦门市	专科	民办	
漳州科技职业学院	福建省教育厅	漳州市	专科	民办	
漳州理工职业学院	福建省教育厅	漳州市	专科	民办	
武夷山职业学院	福建省教育厅	南平市	专科	民办	
漳州卫生职业学院	福建省	漳州市	专科		
泉州海洋职业学院	福建省教育厅	泉州市	专科	民办	
泉州轻工职业学院	福建省教育厅	泉州市	专科	民办	
厦门安防科技职业学院	福建省教育厅	厦门市	专科	民办	
泉州幼儿师范高等专科学校	福建省	泉州市	专科		
闽江师范高等专科学校	福建省	福州市	专科		
泉州工程职业技术学院	福建省教育厅	泉州市	专科	民办	
南昌大学	江西省	南昌市	本科		
华东交通大学	江西省	南昌市	本科		
东华理工大学	江西省	抚州市	本科		
南昌航空大学	江西省	南昌市	本科		
江西理工大学	江西省	赣州市	本科		
景德镇陶瓷学院	江西省	景德镇市	本科		
江西农业大学	江西省	南昌市	本科		
江西中医药大学	江西省	南昌市	本科		
赣南医学院	江西省	赣州市	本科		
江西师范大学	江西省	南昌市	本科		
上饶师范学院	江西省	上饶市	本科		
宜春学院	江西省	宜春市	本科		
赣南师范学院	江西省	赣州市	本科		
井冈山大学	江西省	吉安市	本科		
江西财经大学	江西省	南昌市	本科		
江西科技学院	江西省教育厅	南昌市	本科	民办	
景德镇学院	江西省	景德镇市	本科		
萍乡学院	江西省	萍乡市	本科		
江西科技师范大学	江西省	南昌市	本科		
南昌工程学院	江西省	南昌市	本科		
江西警察学院	江西省	南昌市	本科		
新余学院	江西省	新余市	本科		
九江学院	江西省	九江市	本科		
江西工程学院	江西省教育厅	新余市	本科	民办	
南昌理工学院	江西省教育厅	南昌市	本科	民办	
江西应用科技学院	江西省教育厅	南昌市	本科	民办	
江西服装学院	江西省教育厅	南昌市	本科	民办	
南昌工学院	江西省教育厅	南昌市	本科	民办	
南昌大学科学技术学院	江西省教育厅	南昌市	本科	民办	
南昌大学共青学院	江西省教育厅	九江市	本科	民办	
华东交通大学理工学院	江西省教育厅	南昌市	本科	民办	
东华理工大学长江学院	江西省教育厅	抚州市	本科	民办	
南昌航空大学科技学院	江西省教育厅	南昌市	本科	民办	
江西理工大学应用科学学院	江西省教育厅	赣州市	本科	民办	
景德镇陶瓷学院科技艺术学院	江西省教育厅	景德镇市	本科	民办	
江西农业大学南昌商学院	江西省教育厅	南昌市	本科	民办	
江西中医药大学科技学院	江西省教育厅	南昌市	本科	民办	
江西师范大学科学技术学院	江西省教育厅	南昌市	本科	民办	
赣南师范学院科技学院	江西省教育厅	赣州市	本科	民办	
江西科技师范大学理工学院	江西省教育厅	南昌市	本科	民办	
江西财经大学现代经济管理学院	江西省教育厅	南昌市	本科	民办	
南昌师范学院	江西省	南昌市	本科		
江西工业职业技术学院	江西省	南昌市	专科		
江西医学高等专科学校	江西省	上饶市	专科		
九江职业大学	江西省	九江市	专科		
九江职业技术学院	江西省	九江市	专科		
江西司法警官职业学院	江西省	南昌市	专科		
江西陶瓷工艺美术职业技术学院	江西省	景德镇市	专科		
江西旅游商贸职业学院	江西省	南昌市	专科		
江西电力职业技术学院	江西省	南昌市	专科		
江西环境工程职业学院	江西省	赣州市	专科		
江西艺术职业学院	江西省	南昌市	专科		
鹰潭职业技术学院	江西省	鹰潭市	专科		
江西信息应用职业技术学院	江西省	南昌市	专科		
江西交通职业技术学院	江西省	南昌市	专科		
江西财经职业学院	江西省	九江市	专科		
江西应用技术职业学院	江西省	赣州市	专科		
江西现代职业技术学院	江西省	南昌市	专科		
江西工业工程职业技术学院	江西省	萍乡市	专科		
江西机电职业技术学院	江西省	南昌市	专科		
江西科技职业学院	江西省教育厅	南昌市	专科	民办	
南昌职业学院	江西省教育厅	南昌市	专科	民办	
江西外语外贸职业学院	江西省	南昌市	专科		
江西工业贸易职业技术学院	江西省	南昌市	专科		
宜春职业技术学院	江西省	宜春市	专科		
江西应用工程职业学院	江西省	萍乡市	专科		
江西生物科技职业学院	江西省	南昌市	专科		
江西建设职业技术学院	江西省	南昌市	专科		
抚州职业技术学院	江西省	抚州市	专科		
南昌师范高等专科学校	江西省	南昌市	专科		
江西中医药高等专科学校	江西省	抚州市	专科		
江西先锋软件职业技术学院	江西省教育厅	南昌市	专科	民办	
江西经济管理职业学院	江西省	南昌市	专科		
江西制造职业技术学院	江西省	南昌市	专科		
江西工程职业学院	江西省	南昌市	专科		
江西青年职业学院	江西省	南昌市	专科		
上饶职业技术学院	江西省	上饶市	专科		
江西航空职业技术学院	江西省	南昌市	专科		
江西农业工程职业学院	江西省	宜春市	专科		
赣西科技职业学院	江西省教育厅	新余市	专科	民办	
江西卫生职业学院	江西省	南昌市	专科		
江西新能源科技职业学院	江西省教育厅	新余市	专科	民办	
江西枫林涉外经贸职业学院	江西省教育厅	九江市	专科	民办	
江西泰豪动漫职业学院	江西省教育厅	南昌市	专科	民办	
江西冶金职业技术学院	江西省	新余市	专科		
江西管理职业学院	江西省	南昌市	专科		
江西传媒职业学院	江西省	南昌市	专科		
江西工商职业技术学院	江西省教育厅	南昌市	专科	民办	
景德镇陶瓷职业技术学院	江西省教育厅	景德镇市	专科	民办	
共青科技职业学院	江西省教育厅	九江市	专科	民办	
赣州师范高等专科学校	江西省	赣州市	专科		
江西水利职业学院	江西省	南昌市	专科		
宜春幼儿师范高等专科学校	江西省	宜春市	专科		
吉安职业技术学院	江西省	吉安市	专科		
江西洪州职业学院	江西省教育厅	宜春市	专科	民办	
江西师范高等专科学校	江西省	鹰潭市	专科		
南昌影视传播职业学院	江西省教育厅	南昌市	专科	民办	
山东大学	教育部	济南市	本科		
中国海洋大学	教育部	青岛市	本科		
中国石油大学（华东）	教育部	青岛市	本科		
山东科技大学	山东省	青岛市	本科		
青岛科技大学	山东省	青岛市	本科		
济南大学	山东省	济南市	本科		
烟台大学文经学院	山东省教育厅	烟台市	本科	民办	
聊城大学东昌学院	山东省教育厅	聊城市	本科	民办	
青岛理工大学琴岛学院	山东省教育厅	青岛市	本科	民办	
山东师范大学历山学院	山东省教育厅	济南市	本科	民办	
山东财经大学燕山学院	山东省教育厅	济南市	本科	民办	
中国石油大学胜利学院	山东省教育厅	东营市	本科	民办	
山东科技大学泰山科技学院	山东省教育厅	泰安市	本科	民办	
青岛农业大学海都学院	山东省教育厅	烟台市	本科	民办	
山东财经大学东方学院	山东省教育厅	泰安市	本科	民办	
济南大学泉城学院	山东省教育厅	济南市	本科	民办	
北京电影学院现代创意媒体学院	山东省教育厅	青岛市	本科	民办	
青岛理工大学	山东省	青岛市	本科		
山东建筑大学	山东省	济南市	本科		
齐鲁工业大学	山东省	济南市	本科		
山东理工大学	山东省	淄博市	本科		
山东农业大学	山东省	泰安市	本科		
青岛农业大学	山东省	青岛市	本科		
潍坊医学院	山东省	潍坊市	本科		
泰山医学院	山东省	泰安市	本科		
滨州医学院	山东省	滨州市	本科		
山东中医药大学	山东省	济南市	本科		
济宁医学院	山东省	济宁市	本科		
山东师范大学	山东省	济南市	本科		
曲阜师范大学	山东省	济宁市	本科		
聊城大学	山东省	聊城市	本科		
德州学院	山东省	德州市	本科		
滨州学院	山东省	滨州市	本科		
鲁东大学	山东省	烟台市	本科		
临沂大学	山东省	临沂市	本科		
泰山学院	山东省	泰安市	本科		
济宁学院	山东省	济宁市	本科		
菏泽学院	山东省	菏泽市	本科		
山东财经大学	山东省	济南市	本科		
山东体育学院	山东省	济南市	本科		
山东艺术学院	山东省	济南市	本科		
齐鲁医药学院	山东省教育厅	淄博市	本科	民办	
青岛滨海学院	山东省教育厅	青岛市	本科	民办	
枣庄学院	山东省	枣庄市	本科		
山东工艺美术学院	山东省	济南市	本科		
青岛大学	山东省	青岛市	本科		
烟台大学	山东省	烟台市	本科		
潍坊学院	山东省	潍坊市	本科		
山东警察学院	山东省	济南市	本科		
山东交通学院	山东省	济南市	本科		
山东工商学院	山东省	烟台市	本科		
山东女子学院	山东省	济南市	本科		
烟台南山学院	山东省教育厅	烟台市	本科	民办	
潍坊科技学院	山东省教育厅	潍坊市	本科	民办	
山东英才学院	山东省教育厅	济南市	本科	民办	
青岛恒星科技学院	山东省教育厅	青岛市	本科	民办	
青岛黄海学院	山东省教育厅	青岛市	本科	民办	
山东现代学院	山东省教育厅	济南市	本科	民办	
山东协和学院	山东省教育厅	济南市	本科	民办	
山东华宇工学院	山东省教育厅	德州市	本科	民办	
青岛工学院	山东省教育厅	青岛市	本科	民办	
齐鲁理工学院	山东省教育厅	济南市	本科	民办	
山东政法学院	山东省	济南市	本科		
齐鲁师范学院	山东省	济南市	本科		
山东青年政治学院	山东省	济南市	本科		
山东管理学院	山东省	济南市	本科		
山东农业工程学院	山东省	济南市	本科		
山东医学高等专科学校	山东省	临沂市	专科		
菏泽医学专科学校	山东省	菏泽市	专科		
山东商业职业技术学院	山东省	济南市	专科		
山东电力高等专科学校	山东省	济南市	专科		
日照职业技术学院	山东省	日照市	专科		
曲阜远东职业技术学院	山东省教育厅	济宁市	专科	民办	
青岛职业技术学院	山东省	青岛市	专科		
威海职业学院	山东省	威海市	专科		
山东职业学院	山东省	济南市	专科		
山东劳动职业技术学院	山东省	济南市	专科		
莱芜职业技术学院	山东省	莱芜市	专科		
济宁职业技术学院	山东省	济宁市	专科		
潍坊职业学院	山东省	潍坊市	专科		
烟台职业学院	山东省	烟台市	专科		
东营职业学院	山东省	东营市	专科		
聊城职业技术学院	山东省	聊城市	专科		
滨州职业学院	山东省	滨州市	专科		
山东科技职业学院	山东省	潍坊市	专科		
山东服装职业学院	山东省	泰安市	专科		
德州科技职业学院	山东省教育厅	德州市	专科	民办	
山东力明科技职业学院	山东省教育厅	济南市	专科	民办	
山东圣翰财贸职业学院	山东省教育厅	济南市	专科	民办	
山东水利职业学院	山东省	日照市	专科		
山东畜牧兽医职业学院	山东省	潍坊市	专科		
青岛飞洋职业技术学院	山东省教育厅	青岛市	专科	民办	
东营科技职业学院	山东省教育厅	东营市	专科	民办	
山东交通职业学院	山东省	潍坊市	专科		
淄博职业学院	山东省	淄博市	专科		
山东外贸职业学院	山东省	青岛市	专科		
青岛酒店管理职业技术学院	山东省	青岛市	专科		
山东信息职业技术学院	山东省	潍坊市	专科		
青岛港湾职业技术学院	山东省	青岛市	专科		
山东胜利职业学院	山东省	东营市	专科		
山东经贸职业学院	山东省	潍坊市	专科		
山东工业职业学院	山东省	淄博市	专科		
山东化工职业学院	山东省	淄博市	专科		
青岛求实职业技术学院	山东省教育厅	青岛市	专科	民办	
济南职业学院	山东省	济南市	专科		
烟台工程职业技术学院	山东省	烟台市	专科		
山东凯文科技职业学院	山东省教育厅	济南市	专科	民办	
山东外国语职业学院	山东省教育厅	日照市	专科	民办	
潍坊工商职业学院	山东省教育厅	潍坊市	专科	民办	
德州职业技术学院	山东省	德州市	专科		
枣庄科技职业学院	山东省	枣庄市	专科		
淄博师范高等专科学校	山东省	淄博市	专科		
山东中医药高等专科学校	山东省	烟台市	专科		
济南工程职业技术学院	山东省	济南市	专科		
山东电子职业技术学院	山东省	济南市	专科		
山东旅游职业学院	山东省	济南市	专科		
山东铝业职业学院	山东省	淄博市	专科		
山东杏林科技职业学院	山东省教育厅	济南市	专科	民办	
泰山职业技术学院	山东省	泰安市	专科		
山东外事翻译职业学院	山东省教育厅	威海市	专科	民办	
山东药品食品职业学院	山东省	威海市	专科		
山东商务职业学院	山东省	烟台市	专科		
山东轻工职业学院	山东省	淄博市	专科		
山东城市建设职业学院	山东省	济南市	专科		
烟台汽车工程职业学院	山东省	烟台市	专科		
山东司法警官职业学院	山东省	济南市	专科		
菏泽家政职业学院	山东省	菏泽市	专科		
山东传媒职业学院	山东省	济南市	专科		
临沂职业学院	山东省	临沂市	专科		
枣庄职业学院	山东省	枣庄市	专科		
山东理工职业学院	山东省	济宁市	专科		
山东文化产业职业学院	山东省教育厅	烟台市	专科	民办	
青岛远洋船员职业学院	山东省	青岛市	专科		
济南幼儿师范高等专科学校	山东省	济南市	专科		
济南护理职业学院	山东省	济南市	专科		
泰山护理职业学院	山东省	泰安市	专科		
山东海事职业学院	山东省教育厅	潍坊市	专科	民办	
潍坊护理职业学院	山东省	潍坊市	专科		
潍坊工程职业学院	山东省	潍坊市	专科		
菏泽职业学院	山东省	菏泽市	专科		
山东艺术设计职业学院	山东省教育厅	济南市	专科	民办	
威海海洋职业学院	山东省	威海市	专科		
山东特殊教育职业学院	山东省	济南市	专科		
华北水利水电大学	河南省	郑州市	本科		
郑州大学	河南省	郑州市	本科		
河南理工大学	河南省	焦作市	本科		
郑州轻工业学院	河南省	郑州市	本科		
河南工业大学	河南省	郑州市	本科		
河南科技大学	河南省	洛阳市	本科		
中原工学院	河南省	郑州市	本科		
河南农业大学	河南省	郑州市	本科		
河南科技学院	河南省	新乡市	本科		
河南牧业经济学院	河南省	郑州市	本科		
河南中医学院	河南省	郑州市	本科		
新乡医学院	河南省	新乡市	本科		
河南大学	河南省	开封市	本科		
河南师范大学	河南省	新乡市	本科		
信阳师范学院	河南省	信阳市	本科		
周口师范学院	河南省	周口市	本科		
安阳师范学院	河南省	安阳市	本科		
许昌学院	河南省	许昌市	本科		
南阳师范学院	河南省	南阳市	本科		
洛阳师范学院	河南省	洛阳市	本科		
商丘师范学院	河南省	商丘市	本科		
河南财经政法大学	河南省	郑州市	本科		
郑州航空工业管理学院	河南省	郑州市	本科		
黄淮学院	河南省	驻马店市	本科		
平顶山学院	河南省	平顶山市	本科		
洛阳理工学院	河南省	洛阳市	本科		
新乡学院	河南省	新乡市	本科		
信阳农林学院	河南省	信阳市	本科		
安阳工学院	河南省	安阳市	本科		
河南工程学院	河南省	郑州市	本科		
南阳理工学院	河南省	南阳市	本科		
河南城建学院	河南省	平顶山市	本科		
河南警察学院	河南省	郑州市	本科		
黄河科技学院	河南省教育厅	郑州市	本科	民办	
铁道警察学院	公安部	郑州市	本科		
郑州科技学院	河南省教育厅	郑州市	本科	民办	
郑州工业应用技术学院	河南省教育厅	郑州市	本科	民办	
郑州师范学院	河南省	郑州市	本科		
郑州财经学院	河南省教育厅	郑州市	本科	民办	
黄河交通学院	河南省教育厅	焦作市	本科	民办	
商丘工学院	河南省教育厅	商丘市	本科	民办	
河南大学民生学院	河南省教育厅	开封市	本科	民办	
河南师范大学新联学院	河南省教育厅	郑州市	本科	民办	
信阳师范学院华锐学院	河南省教育厅	信阳市	本科	民办	
安阳师范学院人文管理学院	河南省教育厅	安阳市	本科	民办	
新乡医学院三全学院	河南省教育厅	新乡市	本科	民办	
河南科技学院新科学院	河南省教育厅	新乡市	本科	民办	
河南理工大学万方科技学院	河南省教育厅	焦作市	本科	民办	
中原工学院信息商务学院	河南省教育厅	郑州市	本科	民办	
商丘学院	河南省教育厅	商丘市	本科	民办	
郑州成功财经学院	河南省教育厅	郑州市	本科	民办	
郑州升达经贸管理学院	河南省教育厅	郑州市	本科	民办	
河南职业技术学院	河南省	郑州市	专科		
漯河职业技术学院	河南省	漯河市	专科		
三门峡职业技术学院	河南省	三门峡市	专科		
郑州铁路职业技术学院	河南省	郑州市	专科		
中州大学	河南省	郑州市	专科		
开封大学	河南省	开封市	专科		
河南机电高等专科学校	河南省	新乡市	专科		
焦作大学	河南省	焦作市	专科		
河南财政税务高等专科学校	河南省	郑州市	专科		
濮阳职业技术学院	河南省	濮阳市	专科		
郑州电力高等专科学校	河南省	郑州市	专科		
黄河水利职业技术学院	河南省	开封市	专科		
许昌职业技术学院	河南省	许昌市	专科		
河南工业和信息化职业学院	河南省	焦作市	专科		
河南水利与环境职业学院	河南省	郑州市	专科		
商丘职业技术学院	河南省	商丘市	专科		
平顶山工业职业技术学院	河南省	平顶山市	专科		
周口职业技术学院	河南省	周口市	专科		
济源职业技术学院	河南省	济源市	专科		
河南司法警官职业学院	河南省	郑州市	专科		
鹤壁职业技术学院	河南省	鹤壁市	专科		
河南工业职业技术学院	河南省	南阳市	专科		
郑州澍青医学高等专科学校	河南省教育厅	郑州市	专科	民办	
焦作师范高等专科学校	河南省	焦作市	专科		
河南检察职业学院	河南省	郑州市	专科		
河南质量工程职业学院	河南省	平顶山市	专科		
郑州信息科技职业学院	河南省	郑州市	专科		
漯河医学高等专科学校	河南省	漯河市	专科		
南阳医学高等专科学校	河南省	南阳市	专科		
商丘医学高等专科学校	河南省	商丘市	专科		
郑州电子信息职业技术学院	河南省教育厅	郑州市	专科	民办	
信阳职业技术学院	河南省	信阳市	专科		
嵩山少林武术职业学院	河南省教育厅	郑州市	专科	民办	
郑州工业安全职业学院	河南省	郑州市	专科		
永城职业学院	河南省	商丘市	专科		
河南经贸职业学院	河南省	郑州市	专科		
河南交通职业技术学院	河南省	郑州市	专科		
河南农业职业学院	河南省	郑州市	专科		
郑州旅游职业学院	河南省	郑州市	专科		
郑州职业技术学院	河南省	郑州市	专科		
河南信息统计职业学院	河南省	郑州市	专科		
河南林业职业学院	河南省	洛阳市	专科		
河南工业贸易职业学院	河南省	郑州市	专科		
郑州电力职业技术学院	河南省教育厅	郑州市	专科	民办	
周口科技职业学院	河南省教育厅	周口市	专科	民办	
河南建筑职业技术学院	河南省	郑州市	专科		
漯河食品职业学院	河南省教育厅	漯河市	专科	民办	
郑州城市职业学院	河南省教育厅	郑州市	专科	民办	
安阳职业技术学院	河南省	安阳市	专科		
新乡职业技术学院	河南省	新乡市	专科		
驻马店职业技术学院	河南省	驻马店市	专科		
焦作工贸职业学院	河南省教育厅	焦作市	专科	民办	
许昌陶瓷职业学院	河南省教育厅	许昌市	专科	民办	
郑州理工职业学院	河南省教育厅	郑州市	专科	民办	
郑州信息工程职业学院	河南省教育厅	郑州市	专科	民办	
长垣烹饪职业技术学院	河南省教育厅	新乡市	专科	民办	
开封文化艺术职业学院	河南省	开封市	专科		
河南化工职业学院	河南省	郑州市	专科		
河南艺术职业学院	河南省	郑州市	专科		
河南机电职业学院	河南省	郑州市	专科		
河南护理职业学院	河南省	安阳市	专科		
许昌电气职业学院	河南省	许昌市	专科		
信阳涉外职业技术学院	河南省教育厅	信阳市	专科	民办	
鹤壁汽车工程职业学院	河南省教育厅	鹤壁市	专科	民办	
南阳职业学院	河南省教育厅	南阳市	专科	民办	
郑州商贸旅游职业学院	河南省教育厅	郑州市	专科	民办	
河南推拿职业学院	河南省	洛阳市	专科		
洛阳职业技术学院	河南省	洛阳市	专科		
郑州幼儿师范高等专科学校	河南省	郑州市	专科		
安阳幼儿师范高等专科学校	河南省	安阳市	专科		
郑州黄河护理职业学院	河南省教育厅	郑州市	专科	民办	
河南医学高等专科学校	河南省	郑州市	专科		
郑州财税金融职业学院	河南省	郑州市	专科		
南阳农业职业学院	河南省	南阳市	专科		
洛阳科技职业学院	河南省教育厅	洛阳市	专科	民办	
鹤壁能源化工职业学院	河南省教育厅	鹤壁市	专科	民办	
平顶山文化艺术职业学院	河南省教育厅	平顶山市	专科	民办	
武汉大学	教育部	武汉市	本科		
华中科技大学	教育部	武汉市	本科		
武汉科技大学	湖北省	武汉市	本科		
长江大学	湖北省	荆州市	本科		
武汉工程大学	湖北省	武汉市	本科		
中国地质大学（武汉）	教育部	武汉市	本科		
武汉纺织大学	湖北省	武汉市	本科		
武汉轻工大学	湖北省	武汉市	本科		
武汉理工大学	教育部	武汉市	本科		
湖北工业大学	湖北省	武汉市	本科		
华中农业大学	教育部	武汉市	本科		
湖北中医药大学	湖北省	武汉市	本科		
华中师范大学	教育部	武汉市	本科		
湖北大学	湖北省	武汉市	本科		
湖北师范学院	湖北省	黄石市	本科		
黄冈师范学院	湖北省	黄冈市	本科		
湖北民族学院	湖北省	恩施土家族
湖北文理学院	湖北省	襄阳市	本科		
中南财经政法大学	教育部	武汉市	本科		
武汉体育学院	湖北省	武汉市	本科		
湖北美术学院	湖北省	武汉市	本科		
中南民族大学	国家民委	武汉市	本科		
湖北汽车工业学院	湖北省	十堰市	本科		
湖北工程学院	湖北省	孝感市	本科		
湖北理工学院	湖北省	黄石市	本科		
湖北科技学院	湖北省	咸宁市	本科		
湖北医药学院	湖北省	十堰市	本科		
江汉大学	湖北省	武汉市	本科		
三峡大学	湖北省	宜昌市	本科		
湖北警官学院	湖北省	武汉市	本科		
荆楚理工学院	湖北省	荆门市	本科		
武汉音乐学院	湖北省	武汉市	本科		
湖北经济学院	湖北省	武汉市	本科		
武汉商学院	湖北省	武汉市	本科		
武汉东湖学院	湖北省教育厅	武汉市	本科	民办	
汉口学院	湖北省教育厅	武汉市	本科	民办	
武昌首义学院	湖北省教育厅	武汉市	本科	民办	
武昌理工学院	湖北省教育厅	武汉市	本科	民办	
武汉生物工程学院	湖北省教育厅	武汉市	本科	民办	
武汉大学珞珈学院	湖北省教育厅	武汉市	本科	民办	
湖北大学知行学院	湖北省教育厅	武汉市	本科	民办	
武汉科技大学城市学院	湖北省教育厅	武汉市	本科	民办	
三峡大学科技学院	湖北省教育厅	宜昌市	本科	民办	
江汉大学文理学院	湖北省教育厅	武汉市	本科	民办	
湖北工业大学工程技术学院	湖北省教育厅	武汉市	本科	民办	
武汉工程大学邮电与信息工程学院	湖北省教育厅	武汉市	本科	民办	
武汉纺织大学外经贸学院	湖北省教育厅	武汉市	本科	民办	
武昌工学院	湖北省教育厅	武汉市	本科	民办	
武汉工商学院	湖北省教育厅	武汉市	本科	民办	
长江大学工程技术学院	湖北省教育厅	荆州市	本科	民办	
长江大学文理学院	湖北省教育厅	荆州市	本科	民办	
湖北商贸学院	湖北省教育厅	武汉市	本科	民办	
湖北汽车工业学院科技学院	湖北省教育厅	十堰市	本科	民办	
湖北医药学院药护学院	湖北省教育厅	十堰市	本科	民办	
湖北民族学院科技学院	湖北省教育厅	恩施土家族
湖北经济学院法商学院	湖北省教育厅	武汉市	本科	民办	
武汉体育学院体育科技学院	湖北省教育厅	武汉市	本科	民办	
湖北师范学院文理学院	湖北省教育厅	黄石市	本科	民办	
湖北文理学院理工学院	湖北省教育厅	襄阳市	本科	民办	
湖北工程学院新技术学院	湖北省教育厅	孝感市	本科	民办	
文华学院	湖北省教育厅	武汉市	本科	民办	
武汉学院	湖北省教育厅	武汉市	本科	民办	
武汉工程科技学院	湖北省教育厅	武汉市	本科	民办	
武汉理工大学华夏学院	湖北省教育厅	武汉市	本科	民办	
华中师范大学武汉传媒学院	湖北省教育厅	武汉市	本科	民办	
武汉设计工程学院	湖北省教育厅	武汉市	本科	民办	
湖北第二师范学院	湖北省	武汉市	本科		
郧阳师范高等专科学校	湖北省	十堰市	专科		
武汉职业技术学院	湖北省	武汉市	专科		
黄冈职业技术学院	湖北省	黄冈市	专科		
长江职业学院	湖北省	武汉市	专科		
荆州理工职业学院	湖北省	荆州市	专科		
湖北工业职业技术学院	湖北省	十堰市	专科		
鄂州职业大学	湖北省	鄂州市	专科		
武汉城市职业学院	湖北省	武汉市	专科		
湖北职业技术学院	湖北省	孝感市	专科		
武汉船舶职业技术学院	湖北省	武汉市	专科		
恩施职业技术学院	湖北省	恩施土家族
襄阳职业技术学院	湖北省	襄阳市	专科		
武汉工贸职业学院	湖北省教育厅	武汉市	专科	民办	
荆州职业技术学院	湖北省	荆州市	专科		
武汉工程职业技术学院	湖北省	武汉市	专科		
仙桃职业学院	湖北省	仙桃市	专科		
湖北轻工职业技术学院	湖北省	武汉市	专科		
湖北交通职业技术学院	湖北省	武汉市	专科		
湖北中医药高等专科学校	湖北省	荆州市	专科		
武汉航海职业技术学院	湖北省	武汉市	专科		
武汉铁路职业技术学院	湖北省	武汉市	专科		
武汉软件工程职业学院	湖北省	武汉市	专科		
湖北三峡职业技术学院	湖北省	宜昌市	专科		
随州职业技术学院	湖北省	随州市	专科		
武汉电力职业技术学院	湖北省	武汉市	专科		
湖北水利水电职业技术学院	湖北省	武汉市	专科		
湖北城市建设职业技术学院	湖北省	武汉市	专科		
武汉警官职业学院	湖北省	武汉市	专科		
湖北生物科技职业学院	湖北省	武汉市	专科		
湖北开放职业学院	湖北省教育厅	武汉市	专科	民办	
武汉科技职业学院	湖北省教育厅	武汉市	专科	民办	
武汉外语外事职业学院	湖北省教育厅	武汉市	专科	民办	
武汉信息传播职业技术学院	湖北省教育厅	武汉市	专科	民办	
武昌职业学院	湖北省教育厅	武汉市	专科	民办	
武汉商贸职业学院	湖北省教育厅	武汉市	专科	民办	
湖北艺术职业学院	湖北省	武汉市	专科		
武汉交通职业学院	湖北省	武汉市	专科		
咸宁职业技术学院	湖北省	咸宁市	专科		
长江工程职业技术学院	湖北省	武汉市	专科		
江汉艺术职业学院	湖北省	潜江市	专科		
武汉工业职业技术学院	湖北省	武汉市	专科		
武汉民政职业学院	湖北省	武汉市	专科		
鄂东职业技术学院	湖北省	黄冈市	专科		
湖北财税职业学院	湖北省	武汉市	专科		
黄冈科技职业学院	湖北省教育厅	黄冈市	专科	民办	
湖北国土资源职业学院	湖北省	武汉市	专科		
湖北生态工程职业技术学院	湖北省	武汉市	专科		
三峡电力职业学院	湖北省	宜昌市	专科		
湖北科技职业学院	湖北省教育厅	武汉市	专科	民办	
湖北青年职业学院	湖北省	武汉市	专科		
湖北工程职业学院	湖北省	黄石市	专科		
三峡旅游职业技术学院	湖北省	宜昌市	专科		
天门职业学院	湖北省教育厅	天门市	专科	民办	
湖北体育职业学院	湖北省	武汉市	专科		
襄阳汽车职业技术学院	湖北省	襄阳市	专科		
湖北幼儿师范高等专科学校	湖北省	武汉市	专科		
湘潭大学	湖南省	湘潭市	本科		
吉首大学	湖南省	湘西土家族
湖南大学	教育部	长沙市	本科		
中南大学	教育部	长沙市	本科		
湖南科技大学	湖南省	湘潭市	本科		
长沙理工大学	湖南省	长沙市	本科		
湖南农业大学	湖南省	长沙市	本科		
中南林业科技大学	湖南省	长沙市	本科		
湖南中医药大学	湖南省	长沙市	本科		
湖南师范大学	湖南省	长沙市	本科		
湖南理工学院	湖南省	岳阳市	本科		
湘南学院	湖南省	郴州市	本科		
衡阳师范学院	湖南省	衡阳市	本科		
邵阳学院	湖南省	邵阳市	本科		
怀化学院	湖南省	怀化市	本科		
湖南文理学院	湖南省	常德市	本科		
湖南科技学院	湖南省	永州市	本科		
湖南人文科技学院	湖南省	娄底市	本科		
湖南商学院	湖南省	长沙市	本科		
南华大学	湖南省	衡阳市	本科		
长沙医学院	湖南省教育厅	长沙市	本科	民办	
长沙学院	湖南省	长沙市	本科		
湖南工程学院	湖南省	湘潭市	本科		
湖南城市学院	湖南省	益阳市	本科		
湖南工学院	湖南省	衡阳市	本科		
湖南财政经济学院	湖南省	长沙市	本科		
湖南警察学院	湖南省	长沙市	本科		
湖南工业大学	湖南省	株洲市	本科		
湖南女子学院	湖南省	长沙市	本科		
湖南第一师范学院	湖南省	长沙市	本科		
湖南医药学院	湖南省	怀化市	本科		
湖南涉外经济学院	湖南省教育厅	长沙市	本科	民办	
湘潭大学兴湘学院	湖南省教育厅	湘潭市	本科	民办	
湖南工业大学科技学院	湖南省教育厅	株洲市	本科	民办	
湖南科技大学潇湘学院	湖南省教育厅	湘潭市	本科	民办	
南华大学船山学院	湖南省教育厅	衡阳市	本科	民办	
湖南商学院北津学院	湖南省教育厅	长沙市	本科	民办	
湖南师范大学树达学院	湖南省教育厅	长沙市	本科	民办	
湖南农业大学东方科技学院	湖南省教育厅	长沙市	本科	民办	
中南林业科技大学涉外学院	湖南省教育厅	长沙市	本科	民办	
湖南文理学院芙蓉学院	湖南省教育厅	常德市	本科	民办	
湖南理工学院南湖学院	湖南省教育厅	岳阳市	本科	民办	
衡阳师范学院南岳学院	湖南省教育厅	衡阳市	本科	民办	
湖南工程学院应用技术学院	湖南省教育厅	湘潭市	本科	民办	
湖南中医药大学湘杏学院	湖南省教育厅	长沙市	本科	民办	
吉首大学张家界学院	湖南省教育厅	张家界市	本科	民办	
长沙理工大学城南学院	湖南省教育厅	长沙市	本科	民办	
长沙师范学院	湖南省	长沙市	本科		
湖南应用技术学院	湖南省教育厅	常德市	本科	民办	
湖南信息学院	湖南省教育厅	长沙市	本科	民办	
湖南交通工程学院	湖南省教育厅	衡阳市	本科	民办	
长沙民政职业技术学院	湖南省	长沙市	专科		
湖南工业职业技术学院	湖南省	长沙市	专科		
株洲师范高等专科学校	湖南省	株洲市	专科		
湖南信息职业技术学院	湖南省	长沙市	专科		
湖南税务高等专科学校	湖南省	长沙市	专科		
湖南冶金职业技术学院	湖南省	株洲市	专科		
长沙航空职业技术学院	总装备部	长沙市	专科		
湖南大众传媒职业技术学院	湖南省	长沙市	专科		
永州职业技术学院	湖南省	永州市	专科		
湖南铁道职业技术学院	湖南省	株洲市	专科		
湖南科技职业学院	湖南省	长沙市	专科		
湖南生物机电职业技术学院	湖南省	长沙市	专科		
湖南交通职业技术学院	湖南省	长沙市	专科		
湖南商务职业技术学院	湖南省	长沙市	专科		
湖南体育职业学院	湖南省	长沙市	专科		
湖南工程职业技术学院	湖南省	长沙市	专科		
保险职业学院	湖南省	长沙市	专科		
湖南外贸职业学院	湖南省	长沙市	专科		
湖南网络工程职业学院	湖南省	长沙市	专科		
邵阳职业技术学院	湖南省	邵阳市	专科		
湖南司法警官职业学院	湖南省	长沙市	专科		
长沙商贸旅游职业技术学院	湖南省	长沙市	专科		
湖南环境生物职业技术学院	湖南省	衡阳市	专科		
湖南邮电职业技术学院	湖南省	长沙市	专科		
湘潭职业技术学院	湖南省	湘潭市	专科		
郴州职业技术学院	湖南省	郴州市	专科		
娄底职业技术学院	湖南省	娄底市	专科		
张家界航空工业职业技术学院	湖南省	张家界市	专科		
长沙环境保护职业技术学院	湖南省	长沙市	专科		
湖南艺术职业学院	湖南省	长沙市	专科		
湖南机电职业技术学院	湖南省	长沙市	专科		
长沙职业技术学院	湖南省	长沙市	专科		
怀化职业技术学院	湖南省	怀化市	专科		
岳阳职业技术学院	湖南省	岳阳市	专科		
常德职业技术学院	湖南省	常德市	专科		
长沙南方职业学院	湖南省教育厅	长沙市	专科	民办	
潇湘职业学院	湖南省教育厅	娄底市	专科	民办	
湖南化工职业技术学院	湖南省	株洲市	专科		
湖南城建职业技术学院	湖南省	湘潭市	专科		
湖南石油化工职业技术学院	湖南省	岳阳市	专科		
湖南中医药高等专科学校	湖南省	株洲市	专科		
邵阳医学高等专科学校	湖南省	邵阳市	专科		
湖南民族职业学院	湖南省	岳阳市	专科		
湘西民族职业技术学院	湖南省	湘西土家族
湖南财经工业职业技术学院	湖南省	衡阳市	专科		
益阳职业技术学院	湖南省	益阳市	专科		
湖南工艺美术职业学院	湖南省	益阳市	专科		
湖南九嶷职业技术学院	湖南省教育厅	永州市	专科	民办	
湖南理工职业技术学院	湖南省	湘潭市	专科		
湖南软件职业学院	湖南省教育厅	湘潭市	专科	民办	
湖南汽车工程职业学院	湖南省	株洲市	专科		
长沙电力职业技术学院	湖南省	长沙市	专科		
湖南水利水电职业技术学院	湖南省	长沙市	专科		
湖南现代物流职业技术学院	湖南省	长沙市	专科		
湖南高速铁路职业技术学院	湖南省	衡阳市	专科		
湖南铁路科技职业技术学院	湖南省	株洲市	专科		
湖南安全技术职业学院	湖南省	长沙市	专科		
湖南电气职业技术学院	湖南省	湘潭市	专科		
湖南外国语职业学院	湖南省教育厅	长沙市	专科	民办	
益阳医学高等专科学校	湖南省	益阳市	专科		
湖南都市职业学院	湖南省教育厅	长沙市	专科	民办	
湖南电子科技职业学院	湖南省教育厅	长沙市	专科	民办	
湖南科技工业职业技术学院	湖南省	湘潭市	专科		
湖南高尔夫旅游职业学院	湖南省教育厅	常德市	专科	民办	
湖南工商职业学院	湖南省教育厅	衡阳市	专科	民办	
湖南三一工业职业技术学院	湖南省教育厅	长沙市	专科	民办	
长沙卫生职业学院	湖南省	长沙市	专科		
湖南食品药品职业学院	湖南省	长沙市	专科		
湖南有色金属职业技术学院	湖南省	株洲市	专科		
湖南吉利汽车职业技术学院	湖南省教育厅	湘潭市	专科	民办	
湖南幼儿师范高等专科学校	湖南省	常德市	专科		
湘南幼儿师范高等专科学校	湖南省	郴州市	专科		
湖南劳动人事职业学院	湖南省	长沙市	专科		
中山大学	教育部	广州市	本科		
暨南大学	国务院侨办	广州市	本科		
汕头大学	广东省	汕头市	本科		
华南理工大学	教育部	广州市	本科		
华南农业大学	广东省	广州市	本科		
广东海洋大学	广东省	湛江市	本科		
广州医科大学	广东省	广州市	本科		
广东医学院	广东省	湛江市	本科		
广州中医药大学	广东省	广州市	本科		
广东药学院	广东省	广州市	本科		
华南师范大学	广东省	广州市	本科		
韶关学院	广东省	韶关市	本科		
惠州学院	广东省	惠州市	本科		
韩山师范学院	广东省	潮州市	本科		
岭南师范学院	广东省	湛江市	本科		
肇庆学院	广东省	肇庆市	本科		
嘉应学院	广东省	梅州市	本科		
广州体育学院	广东省	广州市	本科		
广州美术学院	广东省	广州市	本科		
星海音乐学院	广东省	广州市	本科		
广东技术师范学院	广东省	广州市	本科		
深圳大学	广东省	深圳市	本科		
广东财经大学	广东省	广州市	本科		
广东白云学院	广东省教育厅	广州市	本科	民办	
广州大学	广东省	广州市	本科		
广州航海学院	广东省	广州市	本科		
广东警官学院	广东省	广州市	本科		
仲恺农业工程学院	广东省	广州市	本科		
五邑大学	广东省	江门市	本科		
广东金融学院	广东省	广州市	本科		
电子科技大学中山学院	广东省教育厅	中山市	本科	民办	
广东石油化工学院	广东省	茂名市	本科		
东莞理工学院	广东省	东莞市	本科		
广东工业大学	广东省	广州市	本科		
广东外语外贸大学	广东省	广州市	本科		
佛山科学技术学院	广东省	佛山市	本科		
广东培正学院	广东省教育厅	广州市	本科	民办	
南方医科大学	广东省	广州市	本科		
广东东软学院	广东省教育厅	佛山市	本科	民办	
华南理工大学广州学院	广东省教育厅	广州市	本科	民办	
广州大学华软软件学院	广东省教育厅	广州市	本科	民办	
中山大学南方学院	广东省教育厅	广州市	本科	民办	
广东外语外贸大学南国商学院	广东省教育厅	广州市	本科	民办	
广东财经大学华商学院	广东省教育厅	广州市	本科	民办	
广东海洋大学寸金学院	广东省教育厅	湛江市	本科	民办	
华南农业大学珠江学院	广东省教育厅	广州市	本科	民办	
广东技术师范学院天河学院	广东省教育厅	广州市	本科	民办	
北京师范大学珠海分校	广东省教育厅	珠海市	本科	民办	
广东工业大学华立学院	广东省教育厅	广州市	本科	民办	
广州大学松田学院	广东省教育厅	广州市	本科	民办	
广州商学院	广东省教育厅	广州市	本科	民办	
北京理工大学珠海学院	广东省教育厅	珠海市	本科	民办	
吉林大学珠海学院	广东省教育厅	珠海市	本科	民办	
广州工商学院	广东省教育厅	广州市	本科	民办	
广东科技学院	广东省教育厅	东莞市	本科	民办	
广东理工学院	广东省教育厅	肇庆市	本科	民办	
东莞理工学院城市学院	广东省教育厅	东莞市	本科	民办	
中山大学新华学院	广东省教育厅	广州市	本科	民办	
广东第二师范学院	广东省	广州市	本科		
南方科技大学	广东省	深圳市	本科		
北京师范大学-香港浸会大学联合国际学院	广东省教育厅	珠海市	本科	中外合作办学	
香港中文大学（深圳）	广东省教育厅	深圳市	本科	中外合作办学	
顺德职业技术学院	广东省	佛山市	专科		
广东轻工职业技术学院	广东省	广州市	专科		
广东交通职业技术学院	广东省	广州市	专科		
广东水利电力职业技术学院	广东省	广州市	专科		
潮汕职业技术学院	广东省教育厅	揭阳市	专科	民办	
深圳职业技术学院	广东省	深圳市	专科		
民办南华工商学院	广东省教育厅	广州市	专科	民办	
私立华联学院	广东省教育厅	广州市	专科	民办	
广州民航职业技术学院	交通运输部	广州市	专科		
广州番禺职业技术学院	广东省	广州市	专科		
广东松山职业技术学院	广东省	韶关市	专科		
广东农工商职业技术学院	广东省	广州市	专科		
广东新安职业技术学院	广东省教育厅	深圳市	专科	民办	
佛山职业技术学院	广东省	佛山市	专科		
广东科学技术职业学院	广东省	广州市	专科		
广东食品药品职业学院	广东省	广州市	专科		
广州康大职业技术学院	广东省教育厅	广州市	专科	民办	
珠海艺术职业学院	广东省教育厅	珠海市	专科	民办	
广东行政职业学院	广东省	广州市	专科		
广东体育职业技术学院	广东省	广州市	专科		
广东职业技术学院	广东省	佛山市	专科		
广东建设职业技术学院	广东省	广州市	专科		
广东女子职业技术学院	广东省	广州市	专科		
广东机电职业技术学院	广东省	广州市	专科		
广东岭南职业技术学院	广东省教育厅	广州市	专科	民办	
汕尾职业技术学院	广东省	汕尾市	专科		
罗定职业技术学院	广东省	云浮市	专科		
阳江职业技术学院	广东省	阳江市	专科		
河源职业技术学院	广东省	河源市	专科		
广东邮电职业技术学院	广东省	广州市	专科		
汕头职业技术学院	广东省	汕头市	专科		
揭阳职业技术学院	广东省	揭阳市	专科		
深圳信息职业技术学院	广东省	深圳市	专科		
清远职业技术学院	广东省	清远市	专科		
广东工贸职业技术学院	广东省	广州市	专科		
广东司法警官职业学院	广东省	广州市	专科		
广东亚视演艺职业学院	广东省教育厅	东莞市	专科	民办	
广东省外语艺术职业学院	广东省	广州市	专科		
广东文艺职业学院	广东省	广州市	专科		
广州体育职业技术学院	广东省	广州市	专科		
广州工程技术职业学院	广东省	广州市	专科		
中山火炬职业技术学院	广东省	中山市	专科		
江门职业技术学院	广东省	江门市	专科		
茂名职业技术学院	广东省	茂名市	专科		
珠海城市职业技术学院	广东省	珠海市	专科		
广州涉外经济职业技术学院	广东省教育厅	广州市	专科	民办	
广州南洋理工职业学院	广东省教育厅	广州市	专科	民办	
广州科技职业技术学院	广东省教育厅	广州市	专科	民办	
惠州经济职业技术学院	广东省教育厅	惠州市	专科	民办	
广东工商职业学院	广东省教育厅	肇庆市	专科	民办	
肇庆医学高等专科学校	广东省	肇庆市	专科		
广州现代信息工程职业技术学院	广东省教育厅	广州市	专科	民办	
广东理工职业学院	广东省	广州市	专科		
广州华南商贸职业学院	广东省教育厅	广州市	专科	民办	
广州华立科技职业学院	广东省教育厅	广州市	专科	民办	
广州城市职业学院	广东省	广州市	专科		
广东工程职业技术学院	广东省	广州市	专科		
广州铁路职业技术学院	广东省	广州市	专科		
广东科贸职业学院	广东省	广州市	专科		
广州科技贸易职业学院	广东省	广州市	专科		
中山职业技术学院	广东省	中山市	专科		
广州珠江职业技术学院	广东省教育厅	广州市	专科	民办	
广州松田职业学院	广东省教育厅	广州市	专科	民办	
广东文理职业学院	广东省教育厅	湛江市	专科	民办	
广州城建职业学院	广东省教育厅	广州市	专科	民办	
东莞职业技术学院	广东省	东莞市	专科		
广东南方职业学院	广东省教育厅	江门市	专科	民办	
广州华商职业学院	广东省教育厅	广州市	专科	民办	
广州华夏职业学院	广东省教育厅	广州市	专科	民办	
广东环境保护工程职业学院	广东省	佛山市	专科		
广东青年职业学院	广东省	广州市	专科		
广州东华职业学院	广东省教育厅	广州市	专科	民办	
广东创新科技职业学院	广东省教育厅	东莞市	专科	民办	
广东舞蹈戏剧职业学院	广东省	广州市	专科		
惠州卫生职业技术学院	广东省	惠州市	专科		
广东信息工程职业学院	广东省教育厅	肇庆市	专科	民办	
广东生态工程职业学院	广东省	广州市	专科		
惠州城市职业学院	广东省	惠州市	专科		
广东碧桂园职业学院	广东省教育厅	清远市	专科	民办	
公安边防部队高等专科学校	公安部	广州市	专科		
广西大学	广西壮族自治区	南宁市	本科		
广西科技大学	广西壮族自治区	柳州市	本科		
桂林电子科技大学	广西壮族自治区	桂林市	本科		
桂林理工大学	广西壮族自治区	桂林市	本科		
广西医科大学	广西壮族自治区	南宁市	本科		
右江民族医学院	广西壮族自治区	百色市	本科		
广西中医药大学	广西壮族自治区	南宁市	本科		
桂林医学院	广西壮族自治区	桂林市	本科		
广西师范大学	广西壮族自治区	桂林市	本科		
广西师范学院	广西壮族自治区	南宁市	本科		
广西民族师范学院	广西壮族自治区	崇左市	本科		
河池学院	广西壮族自治区	河池市	本科		
玉林师范学院	广西壮族自治区	玉林市	本科		
广西艺术学院	广西壮族自治区	南宁市	本科		
广西民族大学	广西壮族自治区	南宁市	本科		
百色学院	广西壮族自治区	百色市	本科		
梧州学院	广西壮族自治区	梧州市	本科		
广西科技师范学院	广西壮族自治区	柳州市	本科		
广西财经学院	广西壮族自治区	南宁市	本科		
南宁学院	广西壮族自治区教育厅	南宁市	本科	民办	
钦州学院	广西壮族自治区	钦州市	本科		
桂林航天工业学院	广西壮族自治区	桂林市	本科		
桂林旅游学院	广西壮族自治区	桂林市	本科		
贺州学院	广西壮族自治区	贺州市	本科		
广西警察学院	广西壮族自治区	南宁市	本科		
北海艺术设计学院	广西壮族自治区教育厅	北海市	本科	民办	
广西大学行健文理学院	广西壮族自治区教育厅	南宁市	本科	民办	
广西科技大学鹿山学院	广西壮族自治区教育厅	柳州市	本科	民办	
广西民族大学相思湖学院	广西壮族自治区教育厅	南宁市	本科	民办	
广西师范大学漓江学院	广西壮族自治区教育厅	桂林市	本科	民办	
广西师范学院师园学院	广西壮族自治区教育厅	南宁市	本科	民办	
广西中医药大学赛恩斯新医药学院	广西壮族自治区教育厅	南宁市	本科	民办	
桂林电子科技大学信息科技学院	广西壮族自治区教育厅	桂林市	本科	民办	
桂林理工大学博文管理学院	广西壮族自治区教育厅	桂林市	本科	民办	
广西外国语学院	广西壮族自治区教育厅	南宁市	本科	民办	
北京航空航天大学北海学院	广西壮族自治区教育厅	北海市	本科	民办	
广西机电职业技术学院	广西壮族自治区	南宁市	专科		
广西体育高等专科学校	广西壮族自治区	南宁市	专科		
南宁职业技术学院	广西壮族自治区	南宁市	专科		
广西水利电力职业技术学院	广西壮族自治区	南宁市	专科		
桂林师范高等专科学校	广西壮族自治区	桂林市	专科		
广西职业技术学院	广西壮族自治区	南宁市	专科		
柳州职业技术学院	广西壮族自治区	柳州市	专科		
广西生态工程职业技术学院	广西壮族自治区	柳州市	专科		
广西交通职业技术学院	广西壮族自治区	南宁市	专科		
广西工业职业技术学院	广西壮族自治区	南宁市	专科		
广西国际商务职业技术学院	广西壮族自治区	南宁市	专科		
广西农业职业技术学院	广西壮族自治区	南宁市	专科		
柳州铁道职业技术学院	广西壮族自治区	柳州市	专科		
广西建设职业技术学院	广西壮族自治区	南宁市	专科		
广西现代职业技术学院	广西壮族自治区	河池市	专科		
北海职业学院	广西壮族自治区	北海市	专科		
桂林山水职业学院	广西壮族自治区教育厅	桂林市	专科	民办	
广西经贸职业技术学院	广西壮族自治区	南宁市	专科		
广西工商职业技术学院	广西壮族自治区	南宁市	专科		
广西演艺职业学院	广西壮族自治区教育厅	南宁市	专科	民办	
广西电力职业技术学院	广西壮族自治区	南宁市	专科		
广西城市职业学院	广西壮族自治区教育厅	崇左市	专科	民办	
广西英华国际职业学院	广西壮族自治区教育厅	钦州市	专科	民办	
柳州城市职业学院	广西壮族自治区	柳州市	专科		
百色职业学院	广西壮族自治区	百色市	专科		
广西工程职业学院	广西壮族自治区教育厅	百色市	专科	民办	
广西理工职业技术学院	广西壮族自治区教育厅	崇左市	专科	民办	
梧州职业学院	广西壮族自治区	梧州市	专科		
广西经济职业学院	广西壮族自治区教育厅	南宁市	专科	民办	
广西幼儿师范高等专科学校	广西壮族自治区	南宁市	专科		
广西科技职业学院	广西壮族自治区教育厅	崇左市	专科	民办	
广西卫生职业技术学院	广西壮族自治区	南宁市	专科		
广西培贤国际职业学院	广西壮族自治区教育厅	百色市	专科	民办	
广西金融职业技术学院	广西壮族自治区	南宁市	专科		
广西中远职业学院	广西壮族自治区教育厅	崇左市	专科	民办	
海南大学	海南省	海口市	本科		
琼州学院	海南省	三亚市	本科		
海南师范大学	海南省	海口市	本科		
海南医学院	海南省	海口市	本科		
海口经济学院	海南省教育厅	海口市	本科	民办	
三亚学院	海南省教育厅	三亚市	本科	民办	
海南职业技术学院	海南省	海口市	专科		
三亚城市职业学院	海南省教育厅	三亚市	专科	民办	
海南软件职业技术学院	海南省	琼海市	专科		
海南政法职业学院	海南省	海口市	专科		
海南外国语职业学院	海南省	文昌市	专科		
琼台师范高等专科学校	海南省	海口市	专科		
海南经贸职业技术学院	海南省	海口市	专科		
海南工商职业学院	海南省教育厅	海口市	专科	民办	
三亚航空旅游职业学院	海南省教育厅	三亚市	专科	民办	
海南科技职业学院	海南省教育厅	海口市	专科	民办	
三亚理工职业学院	海南省教育厅	三亚市	专科	民办	
重庆大学	教育部	重庆市	本科		
重庆邮电大学	重庆市	重庆市	本科		
重庆交通大学	重庆市	重庆市	本科		
重庆医科大学	重庆市	重庆市	本科		
西南大学	教育部	重庆市	本科		
重庆师范大学	重庆市	重庆市	本科		
重庆文理学院	重庆市	重庆市	本科		
重庆三峡学院	重庆市	重庆市	本科		
长江师范学院	重庆市	重庆市	本科		
四川外国语大学	重庆市	重庆市	本科		
西南政法大学	重庆市	重庆市	本科		
四川美术学院	重庆市	重庆市	本科		
重庆科技学院	重庆市	重庆市	本科		
重庆理工大学	重庆市	重庆市	本科		
重庆工商大学	重庆市	重庆市	本科		
重庆工程学院	重庆市教委	重庆市	本科	民办	
重庆大学城市科技学院	重庆市教委	重庆市	本科	民办	
重庆警察学院	重庆市	重庆市	本科		
重庆人文科技学院	重庆市教委	重庆市	本科	民办	
四川外国语大学重庆南方翻译学院	重庆市教委	重庆市	本科	民办	
重庆师范大学涉外商贸学院	重庆市教委	重庆市	本科	民办	
重庆工商大学融智学院	重庆市教委	重庆市	本科	民办	
重庆工商大学派斯学院	重庆市教委	重庆市	本科	民办	
重庆邮电大学移通学院	重庆市教委	重庆市	本科	民办	
重庆第二师范学院	重庆市	重庆市	本科		
重庆航天职业技术学院	重庆市	重庆市	专科		
重庆电力高等专科学校	重庆市	重庆市	专科		
重庆工业职业技术学院	重庆市	重庆市	专科		
重庆三峡职业学院	重庆市	重庆市	专科		
重庆工贸职业技术学院	重庆市	重庆市	专科		
重庆机电职业技术学院	重庆市教委	重庆市	专科	民办	
重庆电子工程职业学院	重庆市	重庆市	专科		
重庆海联职业技术学院	重庆市教委	重庆市	专科	民办	
重庆信息技术职业学院	重庆市教委	重庆市	专科	民办	
重庆传媒职业学院	重庆市教委	重庆市	专科	民办	
重庆城市管理职业学院	重庆市	重庆市	专科		
重庆工程职业技术学院	重庆市	重庆市	专科		
重庆房地产职业学院	重庆市教委	重庆市	专科	民办	
重庆城市职业学院	重庆市	重庆市	专科		
重庆水利电力职业技术学院	重庆市	重庆市	专科		
重庆工商职业学院	重庆市	重庆市	专科		
重庆应用技术职业学院	重庆市教委	重庆市	专科	民办	
重庆三峡医药高等专科学校	重庆市	重庆市	专科		
重庆医药高等专科学校	重庆市	重庆市	专科		
重庆青年职业技术学院	重庆市	重庆市	专科		
重庆财经职业学院	重庆市	重庆市	专科		
重庆科创职业学院	重庆市教委	重庆市	专科	民办	
重庆建筑工程职业学院	重庆市	重庆市	专科		
重庆电讯职业学院	重庆市教委	重庆市	专科	民办	
重庆能源职业学院	重庆市教委	重庆市	专科	民办	
重庆商务职业学院	重庆市	重庆市	专科		
重庆交通职业学院	重庆市教委	重庆市	专科	民办	
重庆化工职业学院	重庆市	重庆市	专科		
重庆旅游职业学院	重庆市	重庆市	专科		
重庆安全技术职业学院	重庆市	重庆市	专科		
重庆公共运输职业学院	重庆市教委	重庆市	专科	民办	
重庆艺术工程职业学院	重庆市教委	重庆市	专科	民办	
重庆轻工职业学院	重庆市教委	重庆市	专科	民办	
重庆电信职业学院	重庆市教委	重庆市	专科	民办	
重庆经贸职业学院	重庆市教委	重庆市	专科	民办	
重庆幼儿师范高等专科学校	重庆市	重庆市	专科		
重庆文化艺术职业学院	重庆市	重庆市	专科		
重庆服装工程职业学院	重庆市教委	重庆市	专科	民办	
四川大学	教育部	成都市	本科		
西南交通大学	教育部	成都市	本科		
电子科技大学	教育部	成都市	本科		
西南石油大学	四川省	成都市	本科		
成都理工大学	四川省	成都市	本科		
西南科技大学	四川省	绵阳市	本科		
成都信息工程大学	四川省	成都市	本科		
四川理工学院	四川省	自贡市	本科		
西华大学	四川省	成都市	本科		
中国民用航空飞行学院	交通运输部	德阳市	本科		
四川农业大学	四川省	雅安市	本科		
西昌学院	四川省	凉山彝族
四川医科大学	四川省	泸州市	本科		
成都中医药大学	四川省	成都市	本科		
川北医学院	四川省	南充市	本科		
四川师范大学	四川省	成都市	本科		
西华师范大学	四川省	南充市	本科		
绵阳师范学院	四川省	绵阳市	本科		
内江师范学院	四川省	内江市	本科		
宜宾学院	四川省	宜宾市	本科		
四川文理学院	四川省	达州市	本科		
阿坝师范学院	四川省	阿坝藏族
乐山师范学院	四川省	乐山市	本科		
西南财经大学	教育部	成都市	本科		
成都体育学院	四川省	成都市	本科		
四川音乐学院	四川省	成都市	本科		
西南民族大学	国家民委	成都市	本科		
成都学院	四川省	成都市	本科		
成都工业学院	四川省	成都市	本科		
攀枝花学院	四川省	攀枝花市	本科		
四川旅游学院	四川省	成都市	本科		
四川民族学院	四川省	甘孜藏族
四川警察学院	四川省	泸州市	本科		
成都东软学院	四川省教育厅	成都市	本科	民办	
电子科技大学成都学院	四川省教育厅	成都市	本科	民办	
成都理工大学工程技术学院	四川省教育厅	乐山市	本科	民办	
四川传媒学院	四川省教育厅	成都市	本科	民办	
成都信息工程大学银杏酒店管理学院	四川省教育厅	成都市	本科	民办	
成都文理学院	四川省教育厅	成都市	本科	民办	
四川工商学院	四川省教育厅	成都市	本科	民办	
四川外国语大学成都学院	四川省教育厅	成都市	本科	民办	
成都医学院	四川省	成都市	本科		
四川工业科技学院	四川省教育厅	德阳市	本科	民办	
四川大学锦城学院	四川省教育厅	成都市	本科	民办	
西南财经大学天府学院	四川省教育厅	绵阳市	本科	民办	
四川大学锦江学院	四川省教育厅	眉山市	本科	民办	
四川文化艺术学院	四川省教育厅	绵阳市	本科	民办	
西南科技大学城市学院	四川省教育厅	绵阳市	本科	民办	
西南交通大学希望学院	四川省教育厅	南充市	本科	民办	
成都师范学院	四川省	成都市	本科		
四川电影电视学院	四川省教育厅	成都市	本科	民办	
成都纺织高等专科学校	四川省	成都市	专科		
民办四川天一学院	四川省教育厅	成都市	专科	民办	
成都航空职业技术学院	四川省	成都市	专科		
四川电力职业技术学院	四川省	成都市	专科		
成都职业技术学院	四川省	成都市	专科		
四川化工职业技术学院	四川省	泸州市	专科		
四川水利职业技术学院	四川省	成都市	专科		
南充职业技术学院	四川省	南充市	专科		
内江职业技术学院	四川省	内江市	专科		
四川航天职业技术学院	四川省	成都市	专科		
四川邮电职业技术学院	四川省	成都市	专科		
四川机电职业技术学院	四川省	攀枝花市	专科		
绵阳职业技术学院	四川省	绵阳市	专科		
四川交通职业技术学院	四川省	成都市	专科		
四川工商职业技术学院	四川省	成都市	专科		
四川工程职业技术学院	四川省	德阳市	专科		
四川建筑职业技术学院	四川省	德阳市	专科		
达州职业技术学院	四川省	达州市	专科		
四川托普信息技术职业学院	四川省教育厅	成都市	专科	民办	
四川国际标榜职业学院	四川省教育厅	成都市	专科	民办	
成都农业科技职业学院	四川省	成都市	专科		
宜宾职业技术学院	四川省	宜宾市	专科		
泸州职业技术学院	四川省	泸州市	专科		
眉山职业技术学院	四川省	眉山市	专科		
成都艺术职业学院	四川省教育厅	成都市	专科	民办	
四川职业技术学院	四川省	遂宁市	专科		
乐山职业技术学院	四川省	乐山市	专科		
雅安职业技术学院	四川省	雅安市	专科		
四川商务职业学院	四川省	成都市	专科		
四川司法警官职业学院	四川省	德阳市	专科		
广安职业技术学院	四川省	广安市	专科		
四川信息职业技术学院	四川省	广元市	专科		
四川文化传媒职业学院	四川省教育厅	成都市	专科	民办	
四川华新现代职业学院	四川省教育厅	成都市	专科	民办	
四川管理职业学院	四川省	成都市	专科		
四川艺术职业学院	四川省	成都市	专科		
四川中医药高等专科学校	四川省	绵阳市	专科		
四川科技职业学院	四川省教育厅	成都市	专科	民办	
四川文化产业职业学院	四川省	成都市	专科		
四川财经职业学院	四川省	成都市	专科		
四川城市职业学院	四川省教育厅	成都市	专科	民办	
四川现代职业学院	四川省教育厅	成都市	专科	民办	
四川幼儿师范高等专科学校	四川省	绵阳市	专科		
四川长江职业学院	四川省教育厅	成都市	专科	民办	
四川三河职业学院	四川省教育厅	泸州市	专科	民办	
川北幼儿师范高等专科学校	四川省	广元市	专科		
四川卫生康复职业学院	四川省	自贡市	专科		
四川汽车职业技术学院	四川省教育厅	绵阳市	专科	民办	
巴中职业技术学院	四川省教育厅	巴中市	专科	民办	
四川希望汽车职业学院	四川省教育厅	资阳市	专科	民办	
四川电子机械职业技术学院	四川省教育厅	绵阳市	专科	民办	
四川文轩职业学院	四川省教育厅	成都市	专科	民办	
川南幼儿师范高等专科学校	四川省	内江市	专科		
四川护理职业学院	四川省	德阳市	专科		
成都工业职业技术学院	四川省	成都市	专科		
四川西南航空职业学院	四川省教育厅	成都市	专科	民办	
成都工贸职业技术学院	四川省	成都市	专科		
四川应用技术职业学院	四川省教育厅	凉山州	专科	民办	
贵州大学	贵州省	贵阳市	本科		
贵州医科大学	贵州省	贵阳市	本科		
遵义医学院	贵州省	遵义市	本科		
贵阳中医学院	贵州省	贵阳市	本科		
贵州师范大学	贵州省	贵阳市	本科		
遵义师范学院	贵州省	遵义市	本科		
铜仁学院	贵州省	铜仁市	本科		
兴义民族师范学院	贵州省	黔西南布依族
安顺学院	贵州省	安顺市	本科		
贵州工程应用技术学院	贵州省	毕节市	本科		
凯里学院	贵州省	黔东南苗族
黔南民族师范学院	贵州省	黔南布依族
贵州财经大学	贵州省	贵阳市	本科		
贵州民族大学	贵州省	贵阳市	本科		
贵阳学院	贵州省	贵阳市	本科		
六盘水师范学院	贵州省	六盘水市	本科		
贵州商学院	贵州省	贵阳市	本科		
贵阳中医学院时珍学院	贵州省教育厅	贵阳市	本科	民办	
贵州财经大学商务学院	贵州省教育厅	贵阳市	本科	民办	
贵州大学科技学院	贵州省教育厅	贵阳市	本科	民办	
贵州大学明德学院	贵州省教育厅	贵阳市	本科	民办	
贵州民族大学人文科技学院	贵州省教育厅	贵阳市	本科	民办	
贵州师范大学求是学院	贵州省教育厅	贵阳市	本科	民办	
遵义医学院医学与科技学院	贵州省教育厅	遵义市	本科	民办	
贵州医科大学神奇民族医药学院	贵州省教育厅	贵阳市	本科	民办	
贵州师范学院	贵州省	贵阳市	本科		
贵州理工学院	贵州省	贵阳市	本科		
黔南民族医学高等专科学校	贵州省	黔南布依族
贵州警官职业学院	贵州省	贵阳市	专科		
贵州交通职业技术学院	贵州省	贵阳市	专科		
贵州航天职业技术学院	贵州省	遵义市	专科		
贵州电子信息职业技术学院	贵州省	黔东南苗族
安顺职业技术学院	贵州省	安顺市	专科		
黔东南民族职业技术学院	贵州省	黔东南苗族
黔南民族职业技术学院	贵州省	黔南布依族
遵义职业技术学院	贵州省	遵义市	专科		
贵州城市职业学院	贵州省教育厅	贵阳市	专科	民办	
贵州工业职业技术学院	贵州省	贵阳市	专科		
贵州电力职业技术学院	贵州省	贵阳市	专科		
六盘水职业技术学院	贵州省	六盘水市	专科		
铜仁职业技术学院	贵州省	铜仁市	专科		
黔西南民族职业技术学院	贵州省	黔西南布依族
贵州轻工职业技术学院	贵州省	贵阳市	专科		
遵义医药高等专科学校	贵州省	遵义市	专科		
贵阳护理职业学院	贵州省	贵阳市	专科		
贵阳职业技术学院	贵州省	贵阳市	专科		
毕节职业技术学院	贵州省	毕节市	专科		
贵州职业技术学院	贵州省	贵阳市	专科		
贵州盛华职业学院	贵州省教育厅	黔南布依族
贵州工商职业学院	贵州省教育厅	贵阳市	专科	民办	
贵阳幼儿师范高等专科学校	贵州省	贵阳市	专科		
铜仁幼儿师范高等专科学校	贵州省	铜仁市	专科		
黔南民族幼儿师范高等专科学校	贵州省	黔南布依族
毕节医学高等专科学校	贵州省	毕节市	专科		
贵州建设职业技术学院	贵州省	贵阳市	专科		
毕节幼儿师范高等专科学校	贵州省	毕节市	专科		
贵州农业职业学院	贵州省	贵阳市	专科		
云南大学	云南省	昆明市	本科		
昆明理工大学	云南省	昆明市	本科		
云南农业大学	云南省	昆明市	本科		
西南林业大学	云南省	昆明市	本科		
昆明医科大学	云南省	昆明市	本科		
大理大学	云南省	大理白族
云南中医学院	云南省	昆明市	本科		
云南师范大学	云南省	昆明市	本科		
昭通学院	云南省	昭通市	本科		
曲靖师范学院	云南省	曲靖市	本科		
普洱学院	云南省	普洱市	本科		
保山学院	云南省	保山市	本科		
红河学院	云南省	红河哈尼族
云南财经大学	云南省	昆明市	本科		
云南艺术学院	云南省	昆明市	本科		
云南民族大学	云南省	昆明市	本科		
玉溪师范学院	云南省	玉溪市	本科		
楚雄师范学院	云南省	楚雄彝族
云南警官学院	云南省	昆明市	本科		
昆明学院	云南省	昆明市	本科		
文山学院	云南省	文山壮族
云南经济管理学院	云南省教育厅	昆明市	本科	民办	
云南大学滇池学院	云南省教育厅	昆明市	本科	民办	
云南大学旅游文化学院	云南省教育厅	丽江市	本科	民办	
昆明理工大学津桥学院	云南省教育厅	昆明市	本科	民办	
云南师范大学商学院	云南省教育厅	昆明市	本科	民办	
云南师范大学文理学院	云南省教育厅	昆明市	本科	民办	
昆明医科大学海源学院	云南省教育厅	昆明市	本科	民办	
云南艺术学院文华学院	云南省教育厅	昆明市	本科	民办	
云南工商学院	云南省教育厅	昆明市	本科	民办	
滇西科技师范学院	云南省	临沧市	本科		
昆明冶金高等专科学校	云南省	昆明市	专科		
云南国土资源职业学院	云南省	昆明市	专科		
云南交通职业技术学院	云南省	昆明市	专科		
昆明工业职业技术学院	云南省	昆明市	专科		
云南农业职业技术学院	云南省	昆明市	专科		
云南司法警官职业学院	云南省	昆明市	专科		
云南文化艺术职业学院	云南省	昆明市	专科		
云南体育运动职业技术学院	云南省	昆明市	专科		
云南科技信息职业学院	云南省教育厅	昆明市	专科	民办	
西双版纳职业技术学院	云南省	西双版纳
昆明艺术职业学院	云南省教育厅	昆明市	专科	民办	
玉溪农业职业技术学院	云南省	玉溪市	专科		
云南能源职业技术学院	云南省	曲靖市	专科		
云南热带作物职业学院	云南省	普洱市	专科		
云南国防工业职业技术学院	云南省	昆明市	专科		
云南机电职业技术学院	云南省	昆明市	专科		
云南林业职业技术学院	云南省	昆明市	专科		
云南城市建设职业学院	云南省教育厅	昆明市	专科	民办	
云南工程职业学院	云南省教育厅	昆明市	专科	民办	
曲靖医学高等专科学校	云南省	曲靖市	专科		
楚雄医药高等专科学校	云南省	楚雄彝族
保山中医药高等专科学校	云南省	保山市	专科		
丽江师范高等专科学校	云南省	丽江市	专科		
德宏师范高等专科学校	云南省	德宏傣族景颇族自治州	专科		
云南新兴职业学院	云南省教育厅	昆明市	专科	民办	
云南锡业职业技术学院	云南省	红河哈尼族彝族自治州	专科		
云南经贸外事职业学院	云南省教育厅	昆明市	专科	民办	
云南三鑫职业技术学院	云南省教育厅	文山壮族
德宏职业学院	云南省	德宏傣族景颇族自治州	专科		
云南商务职业学院	云南省教育厅	昆明市	专科	民办	
昆明卫生职业学院	云南省教育厅	昆明市	专科	民办	
云南现代职业技术学院	云南省教育厅	楚雄彝族
云南旅游职业学院	云南省	昆明市	专科		
红河卫生职业学院	云南省	红河哈尼族彝族自治州	专科		
云南外事外语职业学院	云南省教育厅	昆明市	专科	民办	
大理农林职业技术学院	云南省	大理白族
公安消防部队高等专科学校	公安部	昆明市	专科		
云南财经职业学院	云南省	昆明市	专科		
西藏大学	西藏自治区	拉萨市	本科		
西藏民族大学	西藏自治区	咸阳市	本科		
西藏藏医学院	西藏自治区	拉萨市	本科		
西藏警官高等专科学校	西藏自治区	拉萨市	专科		
拉萨师范高等专科学校	西藏自治区	拉萨市	专科		
西藏职业技术学院	西藏自治区	拉萨市	专科		
西北大学	陕西省	西安市	本科		
西安交通大学	教育部	西安市	本科		
西北工业大学	工业和信息化部	西安市	本科		
西安理工大学	陕西省	西安市	本科		
西安电子科技大学	教育部	西安市	本科		
西安工业大学	陕西省	西安市	本科		
西安建筑科技大学	陕西省	西安市	本科		
西安科技大学	陕西省	西安市	本科		
西安石油大学	陕西省	西安市	本科		
陕西科技大学	陕西省	西安市	本科		
西安工程大学	陕西省	西安市	本科		
长安大学	教育部	西安市	本科		
西北农林科技大学	教育部	咸阳市	本科		
陕西中医药大学	陕西省	咸阳市	本科		
陕西师范大学	教育部	西安市	本科		
延安大学	陕西省	延安市	本科		
陕西理工学院	陕西省	汉中市	本科		
宝鸡文理学院	陕西省	宝鸡市	本科		
咸阳师范学院	陕西省	咸阳市	本科		
渭南师范学院	陕西省	渭南市	本科		
西安外国语大学	陕西省	西安市	本科		
西北政法大学	陕西省	西安市	本科		
西安体育学院	陕西省	西安市	本科		
西安音乐学院	陕西省	西安市	本科		
西安美术学院	陕西省	西安市	本科		
西安文理学院	陕西省	西安市	本科		
榆林学院	陕西省	榆林市	本科		
商洛学院	陕西省	商洛市	本科		
安康学院	陕西省	安康市	本科		
西安培华学院	陕西省教育厅	西安市	本科	民办	
西安财经学院	陕西省	西安市	本科		
西安邮电大学	陕西省	西安市	本科		
西安航空学院	陕西省	西安市	本科		
西安医学院	陕西省	西安市	本科		
西安欧亚学院	陕西省教育厅	西安市	本科	民办	
西安外事学院	陕西省教育厅	西安市	本科	民办	
西安翻译学院	陕西省教育厅	西安市	本科	民办	
西京学院	陕西省教育厅	西安市	本科	民办	
西安思源学院	陕西省教育厅	西安市	本科	民办	
陕西国际商贸学院	陕西省教育厅	咸阳市	本科	民办	
陕西服装工程学院	陕西省教育厅	咸阳市	本科	民办	
西安交通工程学院	陕西省教育厅	西安市	本科	民办	
西安交通大学城市学院	陕西省教育厅	西安市	本科	民办	
西北大学现代学院	陕西省教育厅	西安市	本科	民办	
西安建筑科技大学华清学院	陕西省教育厅	西安市	本科	民办	
西安财经学院行知学院	陕西省教育厅	西安市	本科	民办	
陕西科技大学镐京学院	陕西省教育厅	咸阳市	本科	民办	
西安工业大学北方信息工程学院	陕西省教育厅	西安市	本科	民办	
延安大学西安创新学院	陕西省教育厅	西安市	本科	民办	
西安电子科技大学长安学院	陕西省教育厅	西安市	本科	民办	
西北工业大学明德学院	陕西省教育厅	西安市	本科	民办	
长安大学兴华学院	陕西省教育厅	西安市	本科	民办	
西安理工大学高科学院	陕西省教育厅	西安市	本科	民办	
西安科技大学高新学院	陕西省教育厅	西安市	本科	民办	
陕西学前师范学院	陕西省	西安市	本科		
陕西工业职业技术学院	陕西省	咸阳市	专科		
杨凌职业技术学院	陕西省	咸阳市	专科		
西安电力高等专科学校	陕西省	西安市	专科		
陕西能源职业技术学院	陕西省	咸阳市	专科		
陕西国防工业职业技术学院	陕西省	西安市	专科		
西安航空职业技术学院	陕西省	西安市	专科		
陕西财经职业技术学院	陕西省	咸阳市	专科		
陕西交通职业技术学院	陕西省	西安市	专科		
陕西职业技术学院	陕西省	西安市	专科		
西安高新科技职业学院	陕西省教育厅	西安市	专科	民办	
西安城市建设职业学院	陕西省教育厅	西安市	专科	民办	
陕西铁路工程职业技术学院	陕西省	渭南市	专科		
宝鸡职业技术学院	陕西省	宝鸡市	专科		
陕西航空职业技术学院	陕西省	汉中市	专科		
陕西电子信息职业技术学院	陕西省教育厅	西安市	专科	民办	
陕西邮电职业技术学院	陕西省	咸阳市	专科		
西安海棠职业学院	陕西省教育厅	西安市	专科	民办	
西安汽车科技职业学院	陕西省教育厅	西安市	专科	民办	
西安东方亚太职业技术学院	陕西省教育厅	西安市	专科	民办	
陕西警官职业学院	陕西省	西安市	专科		
陕西经济管理职业技术学院	陕西省	西安市	专科		
西安铁路职业技术学院	陕西省	西安市	专科		
咸阳职业技术学院	陕西省	咸阳市	专科		
西安职业技术学院	陕西省	西安市	专科		
商洛职业技术学院	陕西省	商洛市	专科		
汉中职业技术学院	陕西省	汉中市	专科		
延安职业技术学院	陕西省	延安市	专科		
渭南职业技术学院	陕西省	渭南市	专科		
安康职业技术学院	陕西省	安康市	专科		
铜川职业技术学院	陕西省	铜川市	专科		
陕西青年职业学院	陕西省	西安市	专科		
陕西工商职业学院	陕西省	西安市	专科		
陕西电子科技职业学院	陕西省教育厅	西安市	专科	民办	
陕西旅游烹饪职业学院	陕西省教育厅	西安市	专科	民办	
西安医学高等专科学校	陕西省教育厅	西安市	专科	民办	
榆林职业技术学院	陕西省	榆林市	专科		
陕西艺术职业学院	陕西省	西安市	专科		
兰州大学	教育部	兰州市	本科		
兰州理工大学	甘肃省	兰州市	本科		
兰州交通大学	甘肃省	兰州市	本科		
甘肃农业大学	甘肃省	兰州市	本科		
甘肃中医药大学	甘肃省	兰州市	本科		
西北师范大学	甘肃省	兰州市	本科		
兰州城市学院	甘肃省	兰州市	本科		
陇东学院	甘肃省	庆阳市	本科		
天水师范学院	甘肃省	天水市	本科		
河西学院	甘肃省	张掖市	本科		
兰州财经大学	甘肃省	兰州市	本科		
西北民族大学	国家民委	兰州市	本科		
甘肃政法学院	甘肃省	兰州市	本科		
甘肃民族师范学院	甘肃省	甘南藏族
兰州文理学院	甘肃省	兰州市	本科		
甘肃医学院	甘肃省	平凉市	本科		
兰州工业学院	甘肃省	兰州市	本科		
西北师范大学知行学院	甘肃省教育厅	兰州市	本科	民办	
兰州财经大学陇桥学院	甘肃省教育厅	兰州市	本科	民办	
兰州财经大学长青学院	甘肃省教育厅	兰州市	本科	民办	
兰州交通大学博文学院	甘肃省教育厅	兰州市	本科	民办	
兰州理工大学技术工程学院	甘肃省教育厅	兰州市	本科	民办	
兰州石化职业技术学院	甘肃省	兰州市	专科		
陇南师范高等专科学校	甘肃省	陇南市	专科		
定西师范高等专科学校	甘肃省	定西市	专科		
甘肃建筑职业技术学院	甘肃省	兰州市	专科		
酒泉职业技术学院	甘肃省	酒泉市	专科		
兰州外语职业学院	甘肃省教育厅	兰州市	专科	民办	
兰州职业技术学院	甘肃省	兰州市	专科		
甘肃警察职业学院	甘肃省	兰州市	专科		
甘肃林业职业技术学院	甘肃省	天水市	专科		
甘肃工业职业技术学院	甘肃省	天水市	专科		
武威职业学院	甘肃省	武威市	专科		
甘肃交通职业技术学院	甘肃省	兰州市	专科		
兰州资源环境职业技术学院	甘肃省	兰州市	专科		
甘肃农业职业技术学院	甘肃省	兰州市	专科		
甘肃畜牧工程职业技术学院	甘肃省	武威市	专科		
甘肃钢铁职业技术学院	甘肃省	嘉峪关市	专科		
甘肃机电职业技术学院	甘肃省	天水市	专科		
甘肃有色冶金职业技术学院	甘肃省	金昌市	专科		
白银矿冶职业技术学院	甘肃省	白银市	专科		
甘肃卫生职业学院	甘肃省	兰州市	专科		
兰州科技职业学院	甘肃省教育厅	兰州市	专科	民办	
庆阳职业技术学院	甘肃省	庆阳市	专科		
临夏现代职业学院	甘肃省	临夏州	专科		
青海大学	青海省	西宁市	本科		
青海师范大学	青海省	西宁市	本科		
青海民族大学	青海省	西宁市	本科		
青海大学昆仑学院	青海省教育厅	西宁市	本科	民办	
青海卫生职业技术学院	青海省	西宁市	专科		
青海警官职业学院	青海省	西宁市	专科		
青海畜牧兽医职业技术学院	青海省	西宁市	专科		
青海交通职业技术学院	青海省	西宁市	专科		
青海建筑职业技术学院	青海省	西宁市	专科		
西宁城市职业技术学院	青海省	西宁市	专科		
青海高等职业技术学院	青海省	海东市	专科		
青海柴达木职业技术学院	青海省	海西蒙古族
宁夏大学	宁夏回族自治区	银川市	本科		
宁夏医科大学	宁夏回族自治区	银川市	本科		
宁夏师范学院	宁夏回族自治区	固原市	本科		
北方民族大学	国家民委	银川市	本科		
宁夏理工学院	宁夏回族自治区教育厅	石嘴山市	本科	民办	
宁夏大学新华学院	宁夏回族自治区教育厅	银川市	本科	民办	
银川能源学院	宁夏回族自治区教育厅	银川市	本科	民办	
中国矿业大学银川学院	宁夏回族自治区教育厅	银川市	本科	民办	
宁夏民族职业技术学院	宁夏回族自治区	吴忠市	专科		
宁夏工业职业学院	宁夏回族自治区	银川市	专科		
宁夏职业技术学院	宁夏回族自治区	银川市	专科		
宁夏工商职业技术学院	宁夏回族自治区	银川市	专科		
宁夏财经职业技术学院	宁夏回族自治区	银川市	专科		
宁夏司法警官职业学院	宁夏回族自治区	银川市	专科		
宁夏建设职业技术学院	宁夏回族自治区	银川市	专科		
宁夏防沙治沙职业技术学院	宁夏回族自治区	银川市	专科		
宁夏幼儿师范高等专科学校	宁夏回族自治区	银川市	专科		
宁夏艺术职业学院	宁夏回族自治区	银川市	专科		
新疆大学	新疆维吾尔自治区	乌鲁木齐市	本科		
塔里木大学	新疆生产建设兵团	阿拉尔市	本科		
新疆农业大学	新疆维吾尔自治区	乌鲁木齐市	本科		
石河子大学	新疆生产建设兵团	石河子市	本科		
新疆医科大学	新疆维吾尔自治区	乌鲁木齐市	本科		
新疆师范大学	新疆维吾尔自治区	乌鲁木齐市	本科		
喀什大学	新疆维吾尔自治区	喀什地区	本科		
伊犁师范学院	新疆维吾尔自治区	伊犁哈萨克
新疆财经大学	新疆维吾尔自治区	乌鲁木齐市	本科		
新疆艺术学院	新疆维吾尔自治区	乌鲁木齐市	本科		
新疆工程学院	新疆维吾尔自治区	乌鲁木齐市	本科		
昌吉学院	新疆维吾尔自治区	昌吉回族
新疆警察学院	新疆维吾尔自治区	乌鲁木齐市	本科		
新疆大学科学技术学院	新疆维吾尔自治区教育厅	乌鲁木齐市	本科	民办	
新疆农业大学科学技术学院	新疆维吾尔自治区教育厅	乌鲁木齐市	本科	民办	
新疆医科大学厚博学院	新疆维吾尔自治区教育厅	乌鲁木齐市	本科	民办	
新疆财经大学商务学院	新疆维吾尔自治区教育厅	乌鲁木齐市	本科	民办	
石河子大学科技学院	新疆维吾尔自治区教育厅	石河子市	本科	民办	
和田师范专科学校	新疆维吾尔自治区	和田地区	专科		
新疆农业职业技术学院	新疆维吾尔自治区	昌吉回族
乌鲁木齐职业大学	新疆维吾尔自治区	乌鲁木齐市	专科		
新疆维吾尔医学专科学校	新疆维吾尔自治区	和田地区	专科		
克拉玛依职业技术学院	新疆维吾尔自治区	克拉玛依市	专科		
新疆机电职业技术学院	新疆维吾尔自治区	乌鲁木齐市	专科		
新疆轻工职业技术学院	新疆维吾尔自治区	乌鲁木齐市	专科		
新疆能源职业技术学院	新疆维吾尔自治区教育厅	乌鲁木齐市	专科	民办	
昌吉职业技术学院	新疆维吾尔自治区	昌吉回族
伊犁职业技术学院	新疆维吾尔自治区	伊犁哈萨克
阿克苏职业技术学院	新疆维吾尔自治区	阿克苏地区	专科		
巴音郭楞职业技术学院	新疆维吾尔自治区	巴音郭楞
新疆建设职业技术学院	新疆维吾尔自治区	乌鲁木齐市	专科		
新疆兵团警官高等专科学校	新疆生产建设兵团	五家渠市	专科		
新疆现代职业技术学院	新疆维吾尔自治区教育厅	乌鲁木齐市	专科	民办	
新疆天山职业技术学院	新疆维吾尔自治区教育厅	乌鲁木齐市	专科	民办	
新疆交通职业技术学院	新疆维吾尔自治区	乌鲁木齐市	专科		
新疆石河子职业技术学院	新疆生产建设兵团	石河子市	专科		
新疆职业大学	新疆维吾尔自治区	乌鲁木齐市	专科		
新疆体育职业技术学院	新疆维吾尔自治区	乌鲁木齐市	专科		
新疆应用职业技术学院	新疆维吾尔自治区	伊犁哈萨克
新疆师范高等专科学校	新疆维吾尔自治区	乌鲁木齐市	专科		
新疆铁道职业技术学院	新疆维吾尔自治区	乌鲁木齐市	专科		
新疆生产建设兵团兴新职业技术学院	新疆生产建设兵团	乌鲁木齐市	专科		
哈密职业技术学院	新疆维吾尔自治区	哈密地区	专科		
新疆科技职业技术学院	新疆维吾尔自治区教育厅	乌鲁木齐市	专科	民办	
